,Unnamed: 0,open,high,low,close,volume,change_in_price,down_days,up_days,RSI,low_14,high_14,k_percent,r_percent,MACD,MACD_EMA,Price_Rate_Of_Change,On_Balance_Volume,Prediction
0,2010-01-04,3289.75,3295.28,3243.32,3243.76,109447927.0,,,,,,,,,0.0,0.0,,0.0,0
1,2010-01-05,3254.468,3290.51,3221.46,3282.179,126115066.0,38.41899999999987,0.0,38.41899999999987,100.0,,,,,0.8619647435898514,0.4788693019943619,,126115066.0,1
2,2010-01-06,3277.517,3295.87,3253.04,3254.215,123651384.0,-27.963999999999945,27.963999999999945,0.0,54.352290275294415,,,,,0.2311522052641521,0.3773459016950956,,2463682.0,0
3,2010-01-07,3253.991,3268.82,3176.71,3192.776,128652827.0,-61.43900000000031,61.43900000000031,0.0,25.195655215923964,,,,,-2.2796503511881383,-0.522720579633913,,-126189145.0,0
4,2010-01-08,3177.259,3198.92,3149.02,3195.997,98377147.0,3.221000000000004,0.0,3.221000000000004,27.546759325204302,,,,,-3.4678195235837848,-1.3988209318322329,,-27811998.0,1
5,2010-01-11,3301.611,3306.75,3197.33,3212.75,136327216.0,16.753000000000156,0.0,16.753000000000156,39.04439301220935,,,,,-3.400518763598484,-1.9413923364874093,,108515218.0,1
6,2010-01-12,3205.705,3275.2,3180.09,3273.966,140655241.0,61.21599999999989,0.0,61.21599999999989,63.479277152819165,,,,,-0.5255974216902359,-1.5830924135236442,,249170459.0,1
7,2010-01-13,3204.976,3232.82,3165.49,3172.658,158344278.0,-101.308,101.308,0.0,35.95619555382905,,,,,-3.407612582282127,-2.021558920185686,,90826181.0,0
8,2010-01-14,3183.381,3219.02,3165.6,3215.55,135954504.0,42.89200000000028,0.0,42.89200000000028,47.15027275229065,,,,,-3.223477360694688,-2.299208042691397,,226780685.0,1
9,2010-01-15,3217.19,3241.82,3197.22,3224.152,120541135.0,8.601999999999862,0.0,8.601999999999862,49.204768135230985,,,,,-2.602875460620453,-2.3672471721769246,-0.0060448368559943,347321820.0,1
10,2010-01-18,3213.637,3238.24,3202.21,3237.098,135067238.0,12.945999999999913,0.0,12.945999999999913,52.41694058322621,,,,,-1.428209940250781,-2.1617911914302,-0.0137350826996334,482389058.0,1
11,2010-01-19,3242.216,3268.81,3236.84,3246.874,129943532.0,9.77599999999984,0.0,9.77599999999984,54.90183680850258,,,,,-0.0105684515119719,-1.699798765693965,-0.0022558435751787,612332590.0,1
12,2010-01-20,3252.037,3255.13,3148.33,3151.85,158243112.0,-95.02399999999987,95.02399999999987,0.0,34.623071513009066,,,,,-4.326798784034963,-2.2557632395435645,-0.0128183123401077,454089478.0,0
13,2010-01-21,3154.189,3176.15,3126.9,3158.863,114337079.0,7.01299999999992,0.0,7.01299999999992,36.61671641310492,3126.9,3306.75,17.772032249096334,-82.22796775090366,-7.09491197865691,-3.268116766331153,-0.0116189095296397,568426557.0,1
14,2010-01-22,3118.724,3147.83,3062.63,3128.588,137758538.0,-30.27499999999964,30.27499999999964,0.0,31.78816392396536,3062.63,3306.75,27.01867933803052,-72.98132066196948,-10.888528234153457,-4.847778464871535,-0.0261962493191191,430668019.0,0
15,2010-01-25,3103.32,3137.0,3092.93,3094.411,78361862.0,-34.177000000000135,34.177000000000135,0.0,27.12844102903567,3062.63,3306.75,13.018597411109276,-86.98140258889072,-15.703067635778552,-7.081716052086374,-0.054843269600234,352306157.0,0
16,2010-01-26,3094.848,3107.2,3001.96,3019.394,93507092.0,-75.01700000000028,75.01700000000028,0.0,19.783708166531326,3001.96,3306.75,5.720003937136961,-94.27999606286303,-23.82234468903744,-10.50697167930862,-0.048307759613548,258799065.0,0
17,2010-01-27,3020.54,3028.65,2972.63,2986.607,76552214.0,-32.78699999999981,32.78699999999981,0.0,17.40705232376405,2972.63,3306.75,4.183227582904306,-95.81677241709568,-31.81516588664317,-14.846789732647014,-0.0711987062866383,182246851.0,0
18,2010-01-28,2985.214,3006.04,2963.89,2994.143,73365767.0,7.536000000000058,0.0,7.536000000000058,19.957215124591784,2963.89,3306.75,8.823718135682244,-91.17628186431776,-37.08732477653166,-19.35993806347509,-0.0713393785404657,255612618.0,1
19,2010-01-29,2979.743,3024.85,2968.45,2989.292,80475875.0,-4.851000000000113,4.851000000000113,0.0,19.509794573351183,2963.89,3275.2,8.159712183996675,-91.84028781600333,-41.01949372009767,-23.74237525561366,-0.0765518992628583,175136743.0,0
20,2010-02-01,2981.374,2981.37,2912.89,2941.36,88147114.0,-47.93199999999979,47.93199999999979,0.0,15.538243909940576,2912.89,3268.81,7.998988536749901,-92.00101146325012,-46.73710498226456,-28.384133867526785,-0.0940948124257361,86989629.0,0
21,2010-02-02,2955.753,2990.75,2930.56,2934.713,82485789.0,-6.646999999999935,6.646999999999935,0.0,15.048085240965122,2912.89,3268.81,6.131434030119216,-93.86856596988078,-51.05270681723778,-32.95155004035631,-0.0688919206180496,4503840.0,0
22,2010-02-03,2945.034,3005.13,2890.02,3003.835,101022537.0,69.12199999999984,0.0,69.12199999999984,38.37394438402409,2890.02,3268.81,30.04699173684629,-69.9530082631537,-49.09841402981829,-36.20009888598189,-0.0490771521272052,105526377.0,1
23,2010-02-04,2983.05,3015.13,2968.68,2995.308,99918364.0,-8.527000000000044,8.527000000000044,0.0,36.93057202127193,2890.02,3268.81,27.795876343092484,-72.20412365690751,-47.58724361894019,-38.48833371603995,-0.0426006875945315,5608013.0,0
24,2010-02-05,2936.197,2959.23,2918.91,2939.402,97274989.0,-55.90599999999995,55.90599999999995,0.0,28.749909317909182,2890.02,3268.81,13.036774994060051,-86.96322500593995,-49.738339847051066,-40.74686744141428,-0.0500932164473303,-91666976.0,0
25,2010-02-08,2936.452,2954.27,2922.19,2935.174,63299582.0,-4.2280000000000655,4.2280000000000655,0.0,28.20471831029367,2890.02,3255.13,12.36723179315822,-87.63276820684179,-51.12684068133149,-42.82915541864659,-0.0278930142935965,-154966558.0,0
26,2010-02-09,2932.09,2957.47,2929.21,2948.842,62282207.0,13.66800000000012,0.0,13.66800000000012,32.94762181409541,2890.02,3176.15,20.55778841785206,-79.44221158214793,-50.64243595650396,-44.39559895428848,-0.0126447838634276,-92684351.0,1
27,2010-02-10,2967.138,2983.18,2958.22,2982.5,55588005.0,33.6579999999999,0.0,33.6579999999999,43.54466319943023,2890.02,3147.83,35.8713781466972,-64.1286218533028,-47.2677678696391,-44.971146007267,-0.0038885918274444,-37096346.0,1
28,2010-02-11,2985.082,3001.64,2976.08,2985.499,56646305.0,2.9989999999997963,0.0,2.9989999999997963,44.44729723252693,2890.02,3137.0,38.65859583771958,-61.34140416228042,-43.86886141745708,-44.750347420040335,-0.0012688623259287,19549959.0,1
29,2010-02-12,2996.088,3018.86,2993.44,3018.133,56092124.0,32.634000000000015,0.0,32.634000000000015,53.73487016260101,2890.02,3107.2,58.98931761672343,-41.01068238327658,-38.336097608078944,-43.46590739791661,0.0261011912856636,75642083.0,1
30,2010-02-22,3016.703,3026.66,3002.81,3003.398,68505143.0,-14.734999999999673,14.734999999999673,0.0,49.42949541971569,2890.02,3028.65,81.7846065065282,-18.215393493471783,-34.64835719046687,-41.70064912931436,0.0234043328938808,7136940.0,0
31,2010-02-23,2998.907,2998.91,2938.75,2982.575,80392858.0,-20.82300000000032,20.82300000000032,0.0,43.717927029177496,2890.02,3026.66,67.73638758782195,-32.26361241217804,-32.89893150068883,-39.938909809898185,-0.0070776191102375,-73255918.0,0
32,2010-02-24,2964.984,3023.74,2955.07,3022.177,92918962.0,39.60200000000032,0.0,39.60200000000032,55.102423575697074,2890.02,3026.66,96.71911592505876,-3.2808840749412505,-28.21892176915708,-37.59342557450055,0.0089703629810358,19663044.0,1
33,2010-02-25,3026.656,3063.0,3022.37,3060.618,119670781.0,38.4409999999998,0.0,38.4409999999998,63.39531349708765,2890.02,3063.0,98.62296219216093,-1.377037807839092,-21.37188449087489,-34.347471463504576,0.0412383199031638,139333825.0,1
34,2010-02-26,3053.498,3067.53,3041.69,3051.943,101296291.0,-8.674999999999727,8.674999999999727,0.0,60.48619136228961,2890.02,3067.53,91.21908624866208,-8.780913751337936,-16.42013159805083,-30.760548461582992,0.0397826500234739,38037534.0,0
35,2010-03-01,3057.006,3093.09,3054.55,3087.842,111038878.0,35.89899999999989,0.0,35.89899999999989,67.58803272553868,2890.02,3093.09,97.41566947358052,-2.5843305264194827,-9.658092037499957,-26.538687104425016,0.047137147395486,149076412.0,1
36,2010-03-02,3089.706,3095.99,3060.96,3073.108,105327647.0,-14.733999999999924,14.733999999999924,0.0,62.28649125768409,2918.91,3095.99,87.07815676530404,-12.921843234695965,-5.369448941739847,-22.30374001676502,0.0303798826487846,43748765.0,0
37,2010-03-03,3074.099,3098.46,3061.47,3097.005,117156519.0,23.89699999999993,0.0,23.89699999999993,67.11391242923872,2918.91,3098.46,99.18964076858818,-0.8103592314118218,-0.1395418380516275,-17.869979524995426,0.0373492002509463,160905284.0,1
38,2010-03-04,3098.069,3102.4,3016.22,3023.373,126383889.0,-73.63200000000006,73.63200000000006,0.0,46.123810402655245,2922.19,3102.4,56.14727262638032,-43.85272737361968,-1.6501979335789656,-14.625484122446975,0.001736172660383,34521395.0,0
39,2010-03-05,3026.639,3044.17,3011.09,3031.065,92259665.0,7.692000000000007,0.0,7.692000000000007,48.08106947963305,2929.21,3102.4,58.81113228246434,-41.18886771753566,-2.226061537060559,-12.14526992835546,0.0092118993220344,126781060.0,1
40,2010-03-08,3036.415,3058.83,3030.91,3053.232,81011950.0,22.16699999999992,0.0,22.16699999999992,53.67690067000305,2938.75,3102.4,69.95539260617166,-30.04460739382835,-0.9524790024411232,-9.90647367351989,0.0236899323571075,207793010.0,1
41,2010-03-09,3053.26,3084.85,3028.69,3069.141,92381803.0,15.909000000000106,0.0,15.909000000000106,57.47259809794056,2938.75,3102.4,79.67674915979224,-20.32325084020776,1.278364884612074,-7.669315645536263,0.0155397913490837,300174813.0,1
42,2010-03-10,3067.15,3085.99,3034.74,3048.927,84612953.0,-20.213999999999945,20.213999999999945,0.0,51.30886695071136,2938.75,3102.4,67.32477849068138,-32.675221509318625,1.452230921193859,-5.844882167681812,-0.0038198167821008,215561860.0,0
43,2010-03-11,3050.644,3070.93,3025.31,3051.282,79872195.0,2.355000000000018,0.0,2.355000000000018,52.00086178714506,2938.75,3102.4,68.76382523678588,-31.23617476321412,1.7537180389404057,-4.325079380423015,-0.0002165833372379,295434055.0,1
44,2010-03-12,3051.474,3057.52,3011.97,3013.412,71418912.0,-37.870000000000346,37.870000000000346,0.0,41.149784858349726,2938.75,3102.4,45.62297586312237,-54.37702413687763,-0.9637006958305392,-3.652774360490956,-0.0241042125860068,224015143.0,0
45,2010-03-15,3010.722,3013.52,2963.49,2976.939,63749768.0,-36.47299999999996,36.47299999999996,0.0,33.403718621175955,2955.07,3102.4,14.843548496572115,-85.15645150342789,-5.912038498163383,-4.10464293334717,-0.0312937260909803,160265375.0,0
46,2010-03-16,2974.487,2993.84,2963.44,2993.838,59627991.0,16.899000000000342,0.0,16.899000000000342,39.49288078097743,2963.44,3102.4,21.875359815774416,-78.12464018422558,-8.405021264929928,-4.964742575742434,-0.0333118609753616,219893366.0,1
47,2010-03-17,2999.815,3050.76,2994.89,3050.479,87085699.0,56.64099999999962,0.0,56.64099999999962,55.29946673956356,2963.44,3102.4,62.63601036269412,-37.36398963730589,-5.847040111367733,-5.14120601813376,0.0089654832533068,306979065.0,1
48,2010-03-18,3053.158,3063.59,3035.02,3046.089,91379124.0,-4.389999999999873,4.389999999999873,0.0,54.03704431032045,2963.44,3102.4,59.47682786413346,-40.52317213586653,-4.119515956761006,-4.936864360282213,0.0049566736444119,215599941.0,0
49,2010-03-19,3046.749,3069.66,3031.02,3067.75,88481189.0,21.661000000000055,0.0,21.661000000000055,59.32376531268344,2963.44,3102.4,75.06476683937818,-24.93523316062182,-1.025620947297739,-4.154604512899695,0.0047549613000257,304081130.0,1
50,2010-03-22,3069.66,3083.34,3061.76,3074.576,96499411.0,6.826000000000022,0.0,6.826000000000022,60.95667053186236,2963.44,3102.4,79.97697179044326,-20.023028209556752,1.943916446486128,-2.9348863943035672,0.0017708537991574,400580541.0,1
51,2010-03-23,3076.957,3082.97,3051.21,3053.125,92867190.0,-21.451000000000025,21.451000000000025,0.0,53.211127675633946,2963.44,3102.4,64.54015544041445,-35.45984455958555,2.565467576251649,-1.8348055516303192,0.0013768778327587,307713351.0,0
52,2010-03-24,3058.928,3076.75,3052.21,3056.808,89266365.0,3.6829999999999927,0.0,3.6829999999999927,54.36001696466214,2963.44,3085.99,76.18767849857213,-23.812321501427867,3.312191450860155,-0.805398628732708,0.0018110420472443,396979716.0,1
53,2010-03-25,3051.356,3051.36,3012.31,3019.176,90190542.0,-37.63200000000006,37.63200000000006,0.0,42.156094065993166,2963.44,3085.99,45.480212158302734,-54.51978784169727,0.9009639383534704,-0.4641241202224605,0.0019127819229498,306789174.0,0
54,2010-03-26,3017.215,3067.71,3009.91,3059.715,93077716.0,40.539000000000215,0.0,40.539000000000215,54.77591740553109,2963.44,3085.99,78.55977152182807,-21.440228478171925,2.19222677090238,0.0671485426612808,0.0278057427444768,399866890.0,1
55,2010-03-29,3076.048,3130.28,3071.69,3123.798,131895114.0,64.08299999999963,0.0,64.08299999999963,67.64939287345287,2963.44,3130.28,96.1148405658113,-3.885159434188696,8.226916667184923,1.6991082734522645,0.0434091624196097,531762004.0,1
56,2010-03-30,3123.832,3132.58,3113.77,3128.468,102431515.0,4.670000000000073,0.0,4.670000000000073,68.4056294929332,2963.44,3132.58,97.56887785266638,-2.431122147333619,13.228440434862025,4.00498160757133,0.0255661487917142,634193519.0,1
57,2010-03-31,3129.574,3130.11,3101.76,3109.105,101143351.0,-19.36299999999983,19.36299999999983,0.0,61.52496595255777,2963.44,3132.58,86.12096488116357,-13.879035118836423,15.467290041493015,6.297448783723986,0.0206875111002995,533050168.0,0
58,2010-04-01,3111.935,3148.34,3111.93,3147.416,126779213.0,38.31100000000015,0.0,38.31100000000015,68.71018782865218,2963.44,3148.34,99.50027041644132,-0.4997295835586683,20.07043866907634,9.05205203756596,0.0259688696927715,659829381.0,1
59,2010-04-02,3154.77,3159.6,3141.87,3157.957,122789383.0,10.540999999999713,0.0,10.540999999999713,70.46147058920157,2963.44,3159.6,99.16241843393146,-0.8375815660685311,24.280519739072588,12.097750245386209,0.0271195117635731,782618764.0,1
60,2010-04-06,3170.612,3177.97,3141.93,3158.681,116814703.0,0.7240000000001601,0.0,0.7240000000001601,70.59191477439171,2994.89,3177.97,89.46416866943426,-10.535831330565744,27.35880270355756,15.14996447902424,0.0345731013306038,899433467.0,1
61,2010-04-07,3156.314,3161.08,3132.24,3148.222,103521570.0,-10.458999999999833,10.458999999999833,0.0,65.75193137486994,3009.91,3177.97,82.29917886469141,-17.70082113530858,28.63034808426937,17.84604384438021,0.0299050512822527,795911897.0,0
62,2010-04-08,3143.451,3143.83,3110.26,3118.709,114643389.0,-29.51300000000037,29.51300000000037,0.0,53.75254487913322,3009.91,3177.97,64.73818874211592,-35.26181125788408,26.962656714129025,19.66936784897875,0.0329669419735716,681268508.0,0
63,2010-04-09,3118.926,3146.46,3114.79,3145.347,105425960.0,26.63800000000037,0.0,26.63800000000037,61.13849409334589,3009.91,3177.97,80.58848030465333,-19.411519695346666,27.459217513873227,21.22733875991184,0.0279869203504248,786694468.0,1
64,2010-04-12,3151.888,3156.21,3111.9,3129.263,137962701.0,-16.084000000000287,16.084000000000287,0.0,55.01702150504966,3009.91,3177.97,71.01808877781751,-28.981911222182493,26.259947883226232,22.233861090018163,0.0017494729172629,648731767.0,0
65,2010-04-13,3129.692,3173.634,3101.483,3161.251,143982040.0,31.988000000000284,0.0,31.988000000000284,63.42145630307829,3009.91,3177.97,90.05176722599096,-9.948232774009046,27.5578776631578,23.298664832414502,0.0104789309016426,792713807.0,1
66,2010-04-14,3161.551,3167.66,3145.55,3166.183,106435847.0,4.931999999999789,0.0,4.931999999999789,64.5981676263805,3009.91,3177.97,92.98643341663704,-7.013566583362972,28.65170827241536,24.36927386449516,0.0183583378496383,899149654.0,1
67,2010-04-15,3168.139,3181.66,3135.99,3164.966,106263908.0,-1.2170000000000982,1.2170000000000982,0.0,64.0118682376594,3009.91,3181.66,90.28005822416306,-9.719941775836949,29.085263293194203,25.31247199274072,0.0055760026637723,792885746.0,0
68,2010-04-16,3159.672,3159.67,3121.37,3130.302,80934918.0,-34.66399999999976,34.66399999999976,0.0,49.304843276887006,3071.69,3181.66,53.298172228789845,-46.70182777121016,26.340697524492956,25.51811714138992,-0.0087572440030057,711950828.0,0
69,2010-04-19,3096.785,3096.78,2977.77,2980.297,129360505.0,-150.0050000000001,150.0050000000001,0.0,22.96238538571504,2977.77,3181.66,1.2393937907695547,-98.76060620923045,11.974794637279048,22.80945219485569,-0.0564742055307262,582590323.0,0
70,2010-04-20,2980.081,2998.91,2941.35,2979.533,101732249.0,-0.7640000000001237,0.7640000000001237,0.0,22.890513708286647,2941.35,3181.66,15.889059964212892,-84.11094003578711,0.5227963730135343,18.352120443722487,-0.0535823077279811,480858074.0,0
71,2010-04-21,2984.618,3034.33,2972.1,3033.278,116308514.0,53.74499999999989,0.0,53.74499999999989,38.5120404411806,2941.35,3181.66,38.25392201739416,-61.74607798260584,-4.183364515319681,13.84502297726129,-0.0273930655280758,597166588.0,1
72,2010-04-22,3021.289,3023.64,2978.46,2999.484,121726664.0,-33.79399999999987,33.79399999999987,0.0,33.576838702936286,2941.35,3181.66,24.191252964920324,-75.80874703507968,-10.509382233139604,8.974141524810161,-0.0463742156270835,475439924.0,0
73,2010-04-23,2995.568,3015.63,2966.78,2983.537,103518713.0,-15.947000000000116,15.947000000000116,0.0,31.38684274179261,2941.35,3181.66,17.555241146851944,-82.44475885314806,-16.613782579922827,3.8565563589390064,-0.046568792715729,371921211.0,0
74,2010-04-26,2988.077,2996.83,2965.83,2969.503,89146675.0,-14.03399999999965,14.03399999999965,0.0,29.43721955514076,2941.35,3181.66,11.715284424285404,-88.2847155757146,-22.323111667216835,-1.3793775286131569,-0.0606557340748963,282774536.0,0
75,2010-04-27,2962.145,2962.15,2866.34,2907.928,108271273.0,-61.57500000000027,61.57500000000027,0.0,22.3948098896946,2866.34,3181.66,13.189141189902251,-86.81085881009774,-31.440377799644462,-7.391577842161177,-0.0815666687617235,174503263.0,0
76,2010-04-28,2883.167,2916.68,2865.47,2900.331,83749411.0,-7.596999999999753,7.596999999999753,0.0,21.657223508800783,2865.47,3181.66,11.025332869477316,-88.97466713052269,-38.82938720111315,-13.679139930927365,-0.0836138524078931,90753852.0,0
77,2010-04-29,2912.196,2928.93,2867.94,2869.139,89344434.0,-31.192000000000007,31.192000000000007,0.0,18.73409895203029,2865.47,3181.66,1.1603782535818097,-98.8396217464182,-46.65819366914593,-20.274950860661534,-0.0834306082927461,1409418.0,0
78,2010-04-30,2867.649,2875.81,2820.95,2870.611,88734444.0,1.4719999999997526,0.0,1.4719999999997526,19.327004102096357,2820.95,3181.66,13.767569515677428,-86.23243048432258,-52.14262670563812,-26.648486170420128,-0.0368037145291224,90143862.0,1
79,2010-05-04,2821.354,2862.55,2809.13,2835.277,66079844.0,-35.33399999999983,35.33399999999983,0.0,16.078052688971454,2809.13,3181.66,7.018763589509557,-92.98123641049044,-58.658146069466966,-33.05041826334185,-0.048415640974609,24064018.0,0
80,2010-05-05,2804.514,2857.29,2770.33,2857.151,95340578.0,21.8739999999998,0.0,21.8739999999998,25.07488093088897,2770.33,3181.66,21.10738336615368,-78.89261663384633,-61.35235517114916,-38.710805724911616,-0.058064905359812,119404596.0,1
81,2010-05-06,2838.951,2838.95,2735.0,2739.702,92649316.0,-117.4489999999996,117.4489999999996,0.0,15.067449213179884,2735.0,3159.67,1.1072126592413465,-98.89278734075866,-72.11713122499987,-45.39207090047981,-0.0866088967302375,26755280.0,0
82,2010-05-07,2685.992,2732.18,2665.81,2688.383,92026260.0,-51.319000000000415,51.319000000000415,0.0,12.5435065462773,2665.81,3096.78,5.237719562846568,-94.76228043715344,-83.81626974212622,-53.07691073832813,-0.0989275480746509,-65270980.0,0
83,2010-05-10,2690.859,2713.06,2646.59,2698.757,81854050.0,10.374000000000253,0.0,10.374000000000253,15.832041831537495,2646.59,3034.33,13.454118739361414,-86.5458812606386,-91.20033398256692,-60.701595442355774,-0.0911755266790436,16583070.0,1
84,2010-05-11,2745.604,2751.07,2638.53,2647.574,87897107.0,-51.18299999999999,51.18299999999999,0.0,13.04056379833591,2638.53,3034.33,2.2849924204143197,-97.71500757958567,-100.02342659552188,-68.56596171852055,-0.0895324781081237,-71314037.0,0
85,2010-05-12,2628.019,2668.12,2604.2,2655.714,82544160.0,8.139999999999873,0.0,8.139999999999873,15.765971210641723,2604.2,3023.64,12.281613580011472,-87.71838641998852,-105.147356911737,-75.88224079105052,-0.0843410631407243,11230123.0,1
86,2010-05-13,2653.579,2711.07,2646.9,2710.507,83077733.0,54.79300000000012,0.0,54.79300000000012,32.256388461883475,2604.2,3015.63,25.838417227718004,-74.161582772282,-103.59735659673196,-81.42526397272563,-0.0552890605857715,94307856.0,1
87,2010-05-14,2692.096,2712.86,2677.19,2696.629,73368024.0,-13.878000000000156,13.878000000000156,0.0,30.510779033670275,2604.2,2996.83,23.54099279219623,-76.45900720780377,-102.3080851401346,-85.60182821858793,-0.0606080029652223,20939832.0,0
88,2010-05-17,2663.882,2663.88,2557.24,2559.931,82648326.0,-136.6979999999999,136.6979999999999,0.0,18.89147045125577,2557.24,2962.15,0.6645921315848599,-99.33540786841512,-111.0258417011164,-90.68663092715182,-0.0971143207524344,-61708494.0,0
89,2010-05-18,2555.141,2603.32,2529.63,2594.783,82792386.0,34.85199999999986,0.0,34.85199999999986,27.06274588840792,2529.63,2928.93,16.31680440771346,-83.68319559228654,-113.81279045811698,-95.31186284211957,-0.0918285382886658,21083892.0,1
90,2010-05-19,2581.63,2623.96,2554.98,2587.807,71372186.0,-6.976000000000113,6.976000000000113,0.0,26.447381063127708,2529.63,2928.93,14.569747057350291,-85.43025294264972,-115.2551038830079,-99.30051105635084,-0.0554421612277541,-50288294.0,0
91,2010-05-20,2571.54,2609.64,2551.45,2555.94,66390044.0,-31.86699999999973,31.86699999999973,0.0,23.61686472778325,2529.63,2875.81,7.600092437460268,-92.39990756253972,-117.61160481914068,-102.96272981335537,-0.0492649298853622,-116678338.0,0
92,2010-05-21,2492.575,2584.45,2481.97,2583.522,83856090.0,27.58199999999988,0.0,27.58199999999988,30.99268925853185,2481.97,2862.55,26.683483104734883,-73.31651689526511,-115.91870678202986,-105.55392520960716,-0.0426992871162539,-32822248.0,1
93,2010-05-24,2596.318,2680.49,2596.32,2673.423,112497272.0,89.90099999999984,0.0,89.90099999999984,49.37700923320721,2481.97,2857.29,51.010604284344,-48.989395715656,-106.10443463492902,-105.66402709475707,0.0097632776269898,79675024.0,1
94,2010-05-25,2654.359,2659.74,2609.09,2622.63,93269050.0,-50.79299999999967,50.79299999999967,0.0,42.07039318078057,2481.97,2838.95,39.40276766205398,-60.59723233794602,-101.25531259815534,-104.78228419488858,-0.0124576667517661,-13594026.0,0
95,2010-05-26,2620.853,2644.94,2610.51,2625.793,68710464.0,3.163000000000011,0.0,3.163000000000011,42.67984877421135,2481.97,2751.07,53.44593088071353,-46.55406911928646,-96.04998283540044,-103.0358239221224,-0.0312539314600552,55116438.0,1
96,2010-05-27,2615.105,2662.08,2583.55,2655.918,87883569.0,30.125,0.0,30.125,48.620169871100096,2481.97,2751.07,64.6406540319584,-35.35934596804159,-88.4752242830682,-100.12370399315294,-0.0150969970285121,143000007.0,1
97,2010-05-28,2680.403,2686.54,2641.41,2655.767,86947998.0,-0.1510000000002946,0.1510000000002946,0.0,48.59104549468848,2481.97,2751.07,64.58454106280186,-35.415458937198146,-81.54431680308244,-96.40782655395611,0.0374369465426998,56052009.0,0
98,2010-05-31,2647.868,2665.39,2591.53,2592.147,78743882.0,-63.61999999999989,63.61999999999989,0.0,37.63220797549388,2481.97,2712.86,47.71839404045216,-52.281605959547846,-80.25758760113149,-93.17777876256874,-0.0010158845652988,-22691873.0,0
99,2010-06-01,2577.763,2598.9,2534.27,2568.283,74666113.0,-23.864000000000036,23.864000000000036,0.0,34.28551126546665,2481.97,2712.86,37.38273636796743,-62.61726363203258,-80.23766995320557,-90.5897570001689,-0.0075446120981973,-97357986.0,0
100,2010-06-02,2548.542,2572.34,2521.06,2571.423,64866634.0,3.1399999999998727,0.0,3.1399999999998727,35.160953690825934,2481.97,2712.86,38.74269132487325,-61.25730867512675,-79.05723107358563,-88.28325181447637,0.0060576539355383,-32491352.0,1
101,2010-06-03,2575.77,2596.14,2551.53,2552.656,69502328.0,-18.766999999999825,18.766999999999825,0.0,32.2024726609116,2481.97,2686.54,34.55345358556978,-65.44654641443022,-78.72794072476381,-86.37218959628473,-0.0119472564971383,-101993680.0,0
102,2010-06-04,2536.231,2556.97,2527.87,2553.593,56518495.0,0.936999999999898,0.0,0.936999999999898,32.529522972356844,2481.97,2686.54,35.01148751038764,-64.98851248961236,-77.49799600926326,-84.59735087869532,-0.0448226861218744,-45475185.0,1
103,2010-06-07,2508.329,2527.1,2491.66,2511.729,65697988.0,-41.86400000000003,41.86400000000003,0.0,26.051022154049814,2481.97,2686.54,14.547098792589331,-85.45290120741068,-78.98969736243134,-83.47582017534896,-0.042286178378193,-111173173.0,0
104,2010-06-08,2510.084,2531.88,2491.65,2513.947,63032468.0,2.218000000000302,0.0,2.218000000000302,26.94051438729069,2481.97,2686.54,15.63132424109121,-84.36867575890878,-79.08131164042197,-82.59691846830489,-0.0425951322133922,-48140705.0,1
105,2010-06-09,2523.879,2589.47,2501.12,2583.87,96030984.0,69.92299999999977,0.0,69.92299999999977,49.1773757812554,2481.97,2686.54,49.81180036173438,-50.18819963826563,-72.67541924601392,-80.61261862374073,-0.0271273435399738,47890279.0,1
106,2010-06-10,2561.549,2581.05,2554.79,2562.58,74583964.0,-21.289999999999964,21.289999999999964,0.0,44.4268081395516,2491.65,2686.54,36.39488942480367,-63.60511057519632,-68.52625990357001,-78.19534687960332,-0.0350885450417901,-26693685.0,0
107,2010-06-11,2574.899,2590.98,2566.62,2569.942,66519280.0,7.36200000000008,0.0,7.36200000000008,46.4892844686762,2491.65,2686.54,40.17240494637999,-59.82759505362001,-63.907400569505626,-75.33775761748612,-0.0085662580092872,39825595.0,1
108,2010-06-17,2588.965,2595.51,2559.72,2560.245,54957039.0,-9.697000000000116,9.697000000000116,0.0,44.00709016878006,2491.65,2686.54,35.196777669454484,-64.80322233054552,-60.33371808313677,-72.33694971053421,-0.0031297174026382,-15131444.0,0
109,2010-06-18,2556.602,2568.86,2505.33,2513.222,67218453.0,-47.02299999999968,47.02299999999968,0.0,33.88426339116893,2491.65,2686.54,11.06880804556423,-88.93119195443577,-60.596634894753606,-69.98888674732673,-0.0226337712620597,-82349897.0,0
110,2010-06-21,2517.292,2587.34,2504.32,2586.21,78554425.0,72.98799999999983,0.0,72.98799999999983,53.17491078116874,2491.65,2686.54,48.51967776694546,-51.480322233054544,-54.290692702318665,-66.84924793827018,0.0131447402235163,-3795472.0,1
111,2010-06-22,2579.631,2598.35,2572.96,2588.698,63681459.0,2.487999999999829,0.0,2.487999999999829,53.706176548161686,2491.65,2665.39,55.85817888799349,-44.14182111200651,-48.53299659852655,-63.18599767027018,0.0137472964564047,59885987.0,1
112,2010-06-23,2576.343,2593.67,2546.52,2569.872,58776822.0,-18.826000000000025,18.826000000000025,0.0,48.86565124218524,2491.65,2598.9,72.93426573426551,-27.0657342657345,-44.97044975368544,-59.54288808691244,0.0231485960467869,1109165.0,0
113,2010-06-24,2563.639,2586.9,2554.34,2566.745,48856571.0,-3.1269999999999527,3.1269999999999527,0.0,48.03589246076184,2491.65,2598.35,70.37956888472345,-29.620431115276546,-41.91620148951688,-56.01755076740175,0.0210020338535377,-47747406.0,0
114,2010-06-25,2556.54,2572.83,2534.27,2552.817,50078852.0,-13.927999999999884,13.927999999999884,0.0,44.180345006538055,2491.65,2598.35,57.32614807872542,-42.67385192127458,-40.156505890147855,-52.84534179192824,-0.0120180194824042,-97826258.0,0
115,2010-06-28,2550.649,2561.49,2528.39,2535.278,43203938.0,-17.539000000000215,17.539000000000215,0.0,39.56603568700725,2491.65,2598.35,40.88847235238967,-59.11152764761033,-39.71914613467607,-50.22010266046276,-0.0106541064083853,-141030196.0,0
116,2010-06-29,2534.496,2541.14,2425.93,2427.053,73744904.0,-108.22499999999992,108.22499999999992,0.0,22.69195352043505,2425.93,2598.35,0.6513165526041335,-99.34868344739589,-47.55618592652672,-49.68731931367311,-0.0556000874727912,-214775100.0,0
117,2010-06-30,2409.542,2411.44,2382.36,2398.37,55210569.0,-28.682999999999996,28.682999999999996,0.0,20.073922706092148,2382.36,2598.35,7.412380202787064,-92.58761979721294,-55.442209032785286,-50.838297257499775,-0.0632263709137211,-269985669.0,0
118,2010-07-01,2393.947,2410.77,2371.78,2373.792,49967686.0,-24.57799999999997,24.57799999999997,0.0,18.01854151897149,2371.78,2598.35,0.8880257756983355,-99.11197422430166,-62.94932555680271,-53.26050291736748,-0.0554785848603904,-319953355.0,0
119,2010-07-02,2371.323,2386.4,2319.74,2382.901,68329570.0,9.108999999999924,0.0,9.108999999999924,21.457575762535512,2319.74,2598.35,22.670040558486782,-77.32995944151322,-67.38700272680171,-56.08580287926095,-0.0786127189980706,-251623785.0,1
120,2010-07-05,2358.757,2378.09,2335.57,2363.947,47996452.0,-18.953999999999724,18.953999999999724,0.0,19.49419616854757,2319.74,2598.35,15.866982520369088,-84.13301747963091,-71.60773117560484,-59.190188538535565,-0.0868200925716324,-299620237.0,0
121,2010-07-06,2358.284,2409.78,2356.55,2409.424,61364295.0,45.47699999999986,0.0,45.47699999999986,35.765752594597544,2319.74,2598.35,32.189799361114154,-67.81020063888585,-70.47100033110246,-61.446350897052326,-0.0624342379698288,-238255942.0,1
122,2010-07-07,2407.665,2421.68,2392.57,2421.117,56110700.0,11.693000000000213,0.0,11.693000000000213,39.39954284236386,2319.74,2598.35,36.38670543053026,-63.61329456946974,-67.84459447897143,-62.725999613437686,-0.0567364502511935,-182145242.0,1
123,2010-07-08,2429.676,2436.28,2402.0,2415.15,54485954.0,-5.967000000000098,5.967000000000098,0.0,38.12946052245231,2319.74,2598.35,34.24500197408574,-65.75499802591426,-65.48967303400559,-63.27873429755181,-0.053927484813835,-236631196.0,0
124,2010-07-09,2416.58,2485.6,2398.68,2470.923,85890148.0,55.77299999999968,0.0,55.77299999999968,54.09044418901255,2319.74,2598.35,54.263307131833,-45.736692868167,-58.44946807415363,-62.31288105287143,-0.0253838040640907,-150741048.0,1
125,2010-07-12,2468.54,2501.02,2455.81,2490.72,82922349.0,19.797000000000025,0.0,19.797000000000025,58.4775855976764,2319.74,2593.67,62.41740590661842,-37.58259409338158,-50.68838735353074,-59.98798231300186,0.0262322248422264,-67818699.0,1
126,2010-07-13,2468.69,2468.69,2439.24,2450.286,66327019.0,-40.43399999999974,40.43399999999974,0.0,47.72890326942618,2319.74,2586.9,48.864350950741176,-51.13564904925882,-47.25545614898101,-57.44147708019644,0.0216463681583742,-134145718.0,0
127,2010-07-14,2456.103,2494.59,2456.1,2470.44,72946145.0,20.154,0.0,20.154,52.72634178465827,2319.74,2572.83,59.544035718519176,-40.45596428148082,-42.4196635610615,-54.43711437636826,0.0407146034698913,-61199573.0,1
128,2010-07-15,2465.989,2487.24,2423.65,2424.304,105539239.0,-46.13599999999997,46.13599999999997,0.0,42.09588194875179,2319.74,2561.49,43.252947259565794,-56.74705274043421,-41.82771880049859,-51.91523526119353,0.0173750399198289,-166738812.0,0
129,2010-07-16,2414.681,2428.46,2389.07,2424.271,70793303.0,-0.0329999999999017,0.0329999999999017,0.0,42.08887847231057,2319.74,2541.14,47.2136404697382,-52.786359530261805,-40.8899046174397,-49.71016913244221,0.0255183386091144,-237532115.0,0
130,2010-07-19,2399.58,2484.19,2392.27,2475.421,88838962.0,51.14999999999964,0.0,51.14999999999964,55.36872268675509,2319.74,2501.02,85.8787511032656,-14.121248896734407,-35.608982131224366,-46.88993173219807,0.0273911939119058,-148693153.0,1
131,2010-07-20,2477.753,2530.33,2477.46,2528.73,118598374.0,53.3090000000002,0.0,53.3090000000002,65.01597407247624,2319.74,2530.33,99.24022983047632,-0.7597701695236754,-26.813289591128974,-42.874603303983605,0.0444476660979209,-30094779.0,1
132,2010-07-21,2529.619,2553.45,2520.15,2535.394,114247832.0,6.66399999999976,0.0,6.66399999999976,66.0737235869652,2319.74,2553.45,92.2741859569552,-7.725814043044815,-19.084930831540987,-38.11666880949447,0.0497873838063886,84153053.0,1
133,2010-07-22,2525.976,2563.24,2522.2,2562.406,105934217.0,27.01200000000017,0.0,27.01200000000017,70.2768931502151,2335.57,2563.24,99.63368032678883,-0.3663196732111539,-10.657721174446124,-32.62487928248424,0.0370238166061833,190087270.0,1
134,2010-07-23,2566.851,2579.52,2549.24,2572.028,114373149.0,9.621999999999844,0.0,9.621999999999844,71.71708831995221,2356.55,2579.52,96.6399067139076,-3.360093286092388,-3.1662078305694195,-26.733144992100787,0.0326443759234278,304460419.0,1
135,2010-07-26,2576.372,2589.48,2556.47,2588.683,93326486.0,16.6550000000002,0.0,16.6550000000002,74.21261198962864,2389.07,2589.48,99.60231525372984,-0.3976847462701592,4.067860593784189,-20.572943874923386,0.0564819780221574,397786905.0,1
136,2010-07-27,2581.59,2588.0,2565.64,2575.368,86605236.0,-13.315000000000056,13.315000000000056,0.0,68.62692546148395,2389.07,2589.48,92.95843520782392,-7.041564792176085,8.627079396895624,-14.732939220559276,0.04247340554719,311181669.0,0
137,2010-07-28,2574.322,2636.0,2564.16,2633.663,128979538.0,58.29500000000007,0.0,58.29500000000007,77.26953950049717,2389.07,2636.0,99.0535779370672,-0.9464220629328112,16.751009199970667,-8.436149536453021,0.0863583939967924,440161207.0,1
138,2010-07-29,2635.048,2656.41,2623.94,2648.116,139123605.0,14.452999999999976,0.0,14.452999999999976,78.92999513454275,2389.07,2656.41,96.8975836014065,-3.102416398593506,24.07793605376446,-1.9333324184093064,0.0923349741014927,579284812.0,1
139,2010-07-30,2642.852,2643.03,2614.73,2637.503,94773788.0,-10.612999999999827,10.612999999999827,0.0,74.32946263287641,2389.07,2656.41,92.92773247549948,-7.07226752450053,28.697406421015785,4.192815349475875,0.0654765391422309,484511024.0,0
140,2010-08-02,2635.807,2675.76,2633.65,2672.516,112944633.0,35.01299999999992,0.0,35.01299999999992,78.99083577379368,2389.07,2675.76,98.8684641947748,-1.1315358052252054,34.782621384050344,10.3107765563909,0.0568609539175792,597455657.0,1
141,2010-08-03,2678.791,2681.79,2626.72,2627.002,127971094.0,-45.51400000000013,45.51400000000013,0.0,62.08216857419913,2389.07,2681.79,81.28313746925387,-18.716862530746123,35.52316872800566,15.353254990713936,0.0361316623767351,469484563.0,0
142,2010-08-04,2620.499,2638.9,2589.99,2638.522,112123737.0,11.519999999999982,0.0,11.519999999999982,64.31315149350202,2389.07,2681.79,85.2186389723968,-14.78136102760319,36.61750625180366,19.606105242931932,0.0297048945405216,581608300.0,1
143,2010-08-05,2636.243,2640.59,2606.62,2620.757,113514382.0,-17.764999999999873,17.764999999999873,0.0,58.21817569214655,2392.27,2681.79,78.91924564796908,-21.080754352030915,35.64046779363025,22.812977753071632,0.0189457502017864,468093918.0,0
144,2010-08-06,2618.713,2659.41,2598.91,2658.392,120927286.0,37.63499999999976,0.0,37.63499999999976,66.07675732137236,2477.46,2681.79,88.54891596926532,-11.451084030734668,37.47100442095461,25.74458308664826,0.0269283647321822,589021204.0,1
145,2010-08-09,2656.36,2676.09,2650.4,2672.53,119964750.0,14.138000000000376,0.0,14.138000000000376,68.63393427636163,2520.15,2681.79,94.27121999505088,-5.728780004949128,39.60596831807607,28.51686013293384,0.0377274238089471,708985954.0,1
146,2010-08-10,2672.793,2675.31,2594.34,2595.274,127010021.0,-77.25600000000031,77.25600000000031,0.0,46.52244130492421,2522.2,2681.79,45.788583244564194,-54.211416755435806,34.664507760177,29.74638965838248,-0.0145762764636174,581975933.0,0
147,2010-08-11,2587.615,2618.45,2586.02,2607.497,86941461.0,12.222999999999956,0.0,12.222999999999956,49.49291025869992,2549.24,2681.79,43.95096190116936,-56.04903809883064,31.37299970158938,30.07171166702386,-0.0153388295678891,668917394.0,1
148,2010-08-12,2584.919,2608.76,2570.96,2575.475,92675203.0,-32.021999999999935,32.021999999999935,0.0,42.37739647367406,2556.47,2681.79,15.165177146505016,-84.83482285349498,25.88221883639835,29.23381310089876,-0.0235176983684948,576242191.0,0
149,2010-08-13,2576.687,2607.03,2564.84,2606.7,88820450.0,31.22499999999991,0.0,31.22499999999991,50.40050120143789,2564.16,2681.79,36.16424381535317,-63.83575618464684,23.776231779846512,28.142296836688303,-0.0246269807177955,665062641.0,1
150,2010-08-16,2603.792,2665.31,2596.77,2661.708,125862823.0,55.008000000000266,0.0,55.008000000000266,61.34167529733982,2564.16,2681.79,82.92782453455763,-17.07217546544237,26.24335351913396,27.76250817317744,0.0132112575475771,790925464.0,1
151,2010-08-17,2663.184,2677.57,2654.01,2671.893,122638294.0,10.184999999999944,0.0,10.184999999999944,63.0815316785388,2564.84,2681.79,91.5374091492091,-8.462590850790894,28.68968589327824,27.947943717197603,0.012647611048913,913563758.0,1
152,2010-08-18,2674.501,2687.76,2654.41,2666.301,136254348.0,-5.592000000000098,5.592000000000098,0.0,61.332823406125534,2564.84,2687.76,82.54230393752012,-17.457696062479886,29.833297236862563,28.3250144211306,0.0173781850053247,777309410.0,0
153,2010-08-19,2669.431,2701.93,2659.3,2687.979,128441613.0,21.677999999999884,0.0,21.677999999999884,65.59853970891407,2564.84,2701.93,89.8234736304617,-10.176526369538298,32.11859569610533,29.083730676125548,0.0111296603360226,905751023.0,1
154,2010-08-20,2677.019,2683.29,2636.91,2642.307,116172184.0,-45.672000000000025,45.672000000000025,0.0,51.72647476620897,2564.84,2701.93,56.50813334305917,-43.49186665694083,29.899719195349466,29.246928379970328,-0.0113087598642486,789578839.0,0
155,2010-08-23,2637.82,2656.12,2629.71,2639.366,88136539.0,-2.9409999999998035,2.9409999999998035,0.0,50.92630523259647,2564.84,2701.93,54.36282733970385,-45.63717266029615,27.585937107306563,28.91473012543758,0.0169893429364298,701442300.0,0
156,2010-08-24,2636.532,2667.17,2614.56,2650.307,107243639.0,10.940999999999804,0.0,10.940999999999804,53.98197888382379,2564.84,2701.93,62.34371580713388,-37.65628419286612,26.33155681572589,28.39809546349524,0.0164180438175001,808685939.0,1
157,2010-08-25,2634.95,2645.503,2595.728,2596.58,109695828.0,-53.72699999999986,53.72699999999986,0.0,39.90357313029706,2564.84,2701.93,23.152673426216246,-76.84732657378375,20.76281164739794,26.871038700275776,0.0081946048787115,698990111.0,0
158,2010-08-26,2604.88,2616.96,2590.61,2603.48,80313857.0,6.900000000000091,0.0,6.900000000000091,42.13966690568844,2564.84,2701.93,28.18586330148075,-71.81413669851925,16.713646380272166,24.83956023627505,-0.001235278321249,779303968.0,1
159,2010-08-27,2602.5,2613.49,2588.64,2610.74,70466094.0,7.2599999999997635,0.0,7.2599999999997635,44.64041322359014,2564.84,2701.93,33.481654387628375,-66.51834561237162,13.929897473398796,22.657627683699804,-0.0191486068344086,849770062.0,1
160,2010-08-30,2622.27,2656.35,2620.19,2652.66,110479525.0,41.92000000000007,0.0,41.92000000000007,57.01737840051448,2564.84,2701.93,64.0601064993799,-35.939893500620094,14.93418503302928,21.1129391535657,-0.0071982672958835,960249587.0,1
161,2010-08-31,2644.79,2647.25,2626.79,2638.8,110890245.0,-13.859999999999673,13.859999999999673,0.0,52.53641281764982,2564.84,2701.93,53.94995988037071,-46.050040119629294,14.445192662982665,19.779389855449097,-0.0103142893469265,849359342.0,0
162,2010-09-01,2641.05,2662.88,2604.49,2622.88,127164940.0,-15.920000000000073,15.920000000000073,0.0,47.580526387734885,2564.84,2701.93,42.33715077686199,-57.66284922313801,12.627494023068266,18.34901068897293,-0.0242185671837464,722194402.0,0
163,2010-09-02,2646.89,2659.98,2636.42,2655.78,124076238.0,32.90000000000009,0.0,32.90000000000009,57.206406128601934,2588.64,2701.93,59.26383617265456,-40.73616382734544,13.683961458713384,17.416000842921022,0.0050989533010359,846270640.0,1
164,2010-09-03,2658.13,2660.54,2631.85,2655.39,129456526.0,-0.3900000000003274,0.3900000000003274,0.0,57.063081899170406,2588.64,2701.93,58.919586900873874,-41.08041309912612,14.324624404216138,16.797725555180044,0.0060711549667609,716814114.0,0
165,2010-09-06,2667.2,2698.6,2664.24,2696.25,144209066.0,40.86000000000013,0.0,40.86000000000013,67.04436364159798,2588.64,2701.93,94.98631829817298,-5.013681701827026,17.922803253859,17.022741094915837,0.0173349728918197,861023180.0,1
166,2010-09-07,2698.22,2704.93,2679.02,2698.36,112231539.0,2.1100000000001278,0.0,2.1100000000001278,67.49460245129606,2588.64,2704.93,94.35033106887978,-5.649668931120226,20.70595928544526,17.759384733021722,0.0391977139159973,973254719.0,1
167,2010-09-08,2687.71,2695.84,2674.32,2695.29,113519409.0,-3.070000000000164,3.070000000000164,0.0,65.98125849305599,2588.64,2704.93,91.71037922435302,-8.289620775646982,22.40562940579412,18.6886336675762,0.0352643385007758,859735310.0,0
168,2010-09-09,2698.64,2698.64,2651.6,2656.35,132989434.0,-38.940000000000055,38.940000000000055,0.0,49.6790239627906,2588.64,2704.93,58.22512683807727,-41.774873161922734,20.375626545660907,19.026032243193143,0.0174701425649432,726745876.0,0
169,2010-09-10,2657.24,2667.84,2628.83,2663.21,113041151.0,6.860000000000127,0.0,6.860000000000127,52.08543687873706,2588.64,2704.93,64.12417232780135,-35.87582767219865,19.10020296952689,19.040866388459893,0.003977139927469,839787027.0,1
170,2010-09-13,2665.66,2696.67,2660.61,2688.32,117918914.0,25.110000000000127,0.0,25.110000000000127,60.13671273282086,2588.64,2704.93,85.71674262619341,-14.283257373806585,19.886346654777757,19.209962441723462,0.0187661058056691,957705941.0,1
171,2010-09-14,2694.07,2703.78,2678.97,2688.52,120712410.0,0.1999999999998181,0.0,0.1999999999998181,60.19817821806756,2588.64,2704.93,85.8887264597129,-14.111273540287092,20.291600476458825,19.426290048670538,0.0250259256999938,1078418351.0,1
172,2010-09-15,2688.39,2688.49,2645.86,2652.5,122039815.0,-36.01999999999998,36.01999999999998,0.0,45.59016918593181,2588.64,2704.93,54.9144380428241,-45.0855619571759,17.50447774863187,19.041927588662805,-0.0012350420592067,956378536.0,0
173,2010-09-16,2646.92,2653.27,2583.34,2602.47,118998200.0,-50.0300000000002,50.0300000000002,0.0,32.824565286460725,2583.34,2704.93,15.733201743564193,-84.2667982564358,11.13036186569434,17.459614444069114,-0.0199292759255702,837380336.0,0
174,2010-09-17,2607.55,2615.08,2592.53,2598.69,83171357.0,-3.779999999999745,3.779999999999745,0.0,32.04238968935567,2583.34,2704.93,12.624393453408956,-87.37560654659104,5.708016692859019,15.109294893827094,-0.0361835883171071,754208979.0,0
175,2010-09-20,2601.48,2607.35,2573.63,2588.71,79469519.0,-9.980000000000018,9.980000000000018,0.0,29.87377668577635,2573.63,2704.93,11.485148514851454,-88.51485148514855,0.5985676041841543,12.207149435898506,-0.0406357935931455,674739460.0,0
176,2010-09-21,2593.76,2601.1,2580.18,2591.55,58101406.0,2.840000000000145,0.0,2.840000000000145,31.39827827260939,2573.63,2704.93,13.648134044173732,-86.35186595582627,-3.1848307980503705,9.12875338910873,-0.0384893647807841,732840866.0,1
177,2010-09-27,2600.54,2629.04,2597.14,2627.97,76844658.0,36.41999999999962,0.0,36.41999999999962,48.094852370127896,2573.63,2704.93,41.38613861386124,-58.613861386138765,-3.2074412965012016,6.661514451986744,-0.0106838330792252,809685524.0,1
178,2010-09-28,2625.33,2625.33,2607.02,2611.35,93117430.0,-16.61999999999989,16.61999999999989,0.0,42.63146944755216,2573.63,2704.93,28.72810357958864,-71.27189642041137,-4.514414716059491,4.426328618377497,-0.0194727415412228,716568094.0,0
179,2010-09-29,2608.92,2634.12,2603.93,2610.68,88618663.0,-0.6700000000000728,0.6700000000000728,0.0,42.4073929491279,2573.63,2704.93,28.21782178217807,-71.78217821782194,-5.540397644570476,2.4329833657879014,-0.0288804904178074,627949431.0,0
180,2010-09-30,2599.72,2656.0,2597.6,2655.66,89580361.0,44.98000000000002,0.0,44.98000000000002,59.07156390257311,2573.63,2703.78,63.027276219746206,-36.972723780253794,-2.69294679483437,1.4077973336634468,-0.012222337940577,717529792.0,1
181,2010-10-08,2681.25,2747.8,2677.99,2738.74,135759543.0,83.07999999999993,0.0,83.07999999999993,74.68325133846031,2573.63,2747.8,94.7981856806566,-5.201814319343398,6.196110129862063,2.365459892903171,0.0325127238454288,853289335.0,1
182,2010-10-11,2755.03,2823.6,2755.03,2806.94,207535265.0,68.20000000000027,0.0,68.20000000000027,81.40243572665086,2573.63,2823.6,93.33520022402692,-6.664799775973064,18.53031193160541,5.59843030064362,0.0785676684073208,1060824600.0,1
183,2010-10-12,2795.76,2843.43,2782.34,2841.41,167428327.0,34.4699999999998,0.0,34.4699999999998,83.89513821189844,2573.63,2843.43,99.25129725722758,-0.748702742772418,30.73243038230885,10.625230316976667,0.0934009058410199,1228252927.0,1
184,2010-10-13,2842.14,2862.03,2826.22,2861.36,185281671.0,19.950000000000276,0.0,19.950000000000276,85.21823102981308,2573.63,2862.03,99.76768377253812,-0.2323162274618836,41.533719480682976,16.80692814971793,0.1053227283086943,1413534598.0,1
185,2010-10-14,2881.55,2919.41,2864.52,2879.64,229461709.0,18.279999999999745,0.0,18.279999999999745,86.39955152187628,2573.63,2919.41,88.49846723350106,-11.501532766498933,50.98118186965121,23.64177889370459,0.1111651328355616,1642996307.0,1
186,2010-10-15,2863.74,2971.16,2858.22,2971.16,236568558.0,91.51999999999998,0.0,91.51999999999998,90.69524981888496,2573.63,2971.16,100.0,-0.0,65.10279456790386,31.93398202854445,0.1305912928990817,1879564865.0,1
187,2010-10-18,2985.46,3026.1,2944.72,2955.23,263316938.0,-15.929999999999836,15.929999999999836,0.0,85.28519272504872,2573.63,3026.1,84.33708312153294,-15.662916878467064,74.15405520688546,40.37799666421265,0.1316866754743715,1616247927.0,0
188,2010-10-19,2949.63,3002.37,2931.91,3001.85,170667828.0,46.61999999999989,0.0,46.61999999999989,87.75224426918386,2573.63,3026.1,94.6405286538334,-5.3594713461666,84.11941086119396,49.12627950360892,0.1498345258706543,1786915755.0,1
189,2010-10-20,2947.51,3041.15,2942.5,3003.95,207804424.0,2.099999999999909,0.0,2.099999999999909,87.85804947495595,2580.18,3041.15,91.930060524546,-8.069939475453989,91.13592111642402,57.52820782617195,0.1311500719218574,1994720179.0,1
190,2010-10-21,3009.23,3018.24,2958.55,2983.53,161436141.0,-20.419999999999614,20.419999999999614,0.0,80.09487091394816,2597.14,3041.15,87.02281480146846,-12.977185198531531,93.96565565371338,64.81569739168023,0.0893805180484457,1833284038.0,0
191,2010-10-22,2976.75,2997.62,2954.62,2975.04,147079881.0,-8.490000000000236,8.490000000000236,0.0,76.83775981794429,2597.6,3041.15,85.09525419907563,-14.904745800924385,94.43458566567232,70.73947504647866,0.0598872793860929,1686204157.0,0
192,2010-10-25,2979.71,3051.54,2959.3,3051.42,192114243.0,76.38000000000011,0.0,76.38000000000011,83.71301067127551,2597.6,3051.54,99.97356478829803,-0.026435211701963,99.81879274963012,76.55533858710896,0.0739104881027377,1878318400.0,1
193,2010-10-26,3065.84,3073.38,3017.82,3041.54,198778908.0,-9.88000000000011,9.88000000000011,0.0,80.16161043908701,2597.6,3073.38,93.3078313506242,-6.69216864937579,102.1115045320248,81.66657177609214,0.0629700561970529,1679539492.0,0
194,2010-10-27,3031.65,3056.4,2988.87,2997.05,176268280.0,-44.48999999999978,44.48999999999978,0.0,65.68337907807783,2677.99,3073.38,80.69500999013636,-19.304990009863644,99.1950659342192,85.17227060771756,0.0407724576683197,1503271212.0,0
195,2010-10-28,2989.29,3007.01,2969.3,2992.58,143537933.0,-4.470000000000255,4.470000000000255,0.0,64.33628452726242,2755.03,3073.38,74.61912988848745,-25.38087011151255,95.42309767319692,87.22243602081345,0.0072093054564548,1359733279.0,0
196,2010-10-29,2993.3,2996.77,2955.48,2978.83,147109754.0,-13.75,13.75,0.0,59.97086499611213,2782.34,3073.38,67.5130566245189,-32.4869433754811,90.28354331085391,87.83465747882155,0.0079858420495189,1212623525.0,0
197,2010-11-01,2986.89,3054.05,2986.89,3054.02,186243180.0,75.19000000000005,0.0,75.19000000000005,71.97093761759709,2826.22,3073.38,92.16701731671787,-7.832982683282126,91.2260159513994,88.51292917333713,0.0173792827756216,1398866705.0,1
198,2010-11-02,3061.63,3089.57,3029.32,3045.43,224947283.0,-8.590000000000146,8.590000000000146,0.0,69.23495054576014,2858.22,3089.57,80.9206829479143,-19.079317052085692,90.2395656640997,88.85825647148965,0.0138084854940994,1173919422.0,0
199,2010-11-03,3044.02,3069.07,3017.1,3030.99,189848032.0,-14.440000000000056,14.440000000000056,0.0,64.4804298675312,2858.22,3089.57,74.67905770477618,-25.320942295223816,87.28642599260911,88.54389037571356,0.0159073312485544,984071390.0,0
200,2010-11-04,3035.37,3087.42,3035.37,3086.94,176857096.0,55.95000000000027,0.0,55.95000000000027,72.82393784852201,2931.91,3089.57,98.33185335532151,-1.6681466446784878,88.44124251619996,88.52336080381085,0.0376129396579543,1160928486.0,1
201,2010-11-05,3129.87,3142.59,3105.92,3129.5,211955803.0,42.559999999999945,0.0,42.559999999999945,77.46917165939877,2931.91,3142.59,93.786785646478,-6.213214353521989,91.7332350167576,89.16533564640021,0.0255880868579219,1372884289.0,1
202,2010-11-08,3140.4,3160.7,3124.09,3159.51,205417960.0,30.01000000000022,0.0,30.01000000000022,80.2199784883116,2942.5,3160.7,99.45462878093512,-0.545371219064895,95.6609981468714,90.46446814649444,0.0387862727434129,1578302249.0,1
203,2010-11-09,3159.02,3159.02,3110.34,3135.0,192455746.0,-24.51000000000022,24.51000000000022,0.0,71.94257482691012,2954.62,3160.7,87.52911490683239,-12.47088509316762,95.69293818733696,91.51016215466296,0.0460285947848717,1385846503.0,0
204,2010-11-10,3120.44,3124.26,3093.88,3115.36,185052423.0,-19.639999999999876,19.639999999999876,0.0,65.67686752326739,2954.62,3160.7,77.99883540372686,-22.00116459627315,93.06072115608733,91.82027395494784,0.0410281429402055,1200794080.0,0
205,2010-11-11,3108.51,3186.72,3102.77,3147.74,210274743.0,32.379999999999654,0.0,32.379999999999654,70.55524439355199,2955.48,3186.72,83.14305483480365,-16.856945165196358,92.52094142943996,91.96040744984629,0.056703470825794,1411068823.0,1
206,2010-11-12,3121.92,3150.15,2975.16,2985.44,233084958.0,-162.29999999999973,162.29999999999973,0.0,38.72381463557543,2955.48,3186.72,12.956235945338204,-87.04376405466179,78.09666026632112,89.18765801314125,-0.0224556486205067,1177983865.0,0
207,2010-11-15,2984.87,3016.13,2939.68,3014.41,153152448.0,28.9699999999998,0.0,28.9699999999998,43.93346354086675,2939.68,3186.72,30.250161917098456,-69.74983808290153,68.2165917622292,84.99344476295884,-0.0101857537359256,1331136313.0,1
208,2010-11-16,3007.64,3007.64,2885.75,2894.54,171089373.0,-119.86999999999988,119.86999999999988,0.0,31.249193804485927,2885.75,3186.72,2.920556866132827,-97.07944313386716,50.13612200625221,78.02198021161752,-0.0450182943526702,1160046940.0,0
209,2010-11-17,2852.48,2891.05,2824.12,2838.86,123780261.0,-55.67999999999984,55.67999999999984,0.0,27.061636940435605,2824.12,3186.72,4.065085493656988,-95.93491450634302,30.95745098207772,68.60907436570956,-0.0803643737811554,1036266679.0,0
210,2010-11-18,2855.6,2873.7,2827.18,2865.45,102226182.0,26.58999999999969,0.0,26.58999999999969,32.07703656511262,2824.12,3186.72,11.398234969663523,-88.60176503033648,17.699774649172923,58.42721442240223,-0.0843745007189648,1138492861.0,1
211,2010-11-19,2879.66,2888.75,2806.64,2888.57,123778460.0,23.120000000000346,0.0,23.120000000000346,36.460437067855054,2806.64,3186.72,21.55598821300787,-78.44401178699214,8.95532981517681,48.53283750095714,-0.0857538035961272,1262271321.0,1
212,2010-11-22,2861.61,2904.97,2852.77,2884.37,127117716.0,-4.200000000000273,4.200000000000273,0.0,35.97381655671093,2806.64,3186.72,20.45095769311725,-79.54904230688275,1.6671713009013729,39.15970426094599,-0.0799457735247208,1135153605.0,0
213,2010-11-23,2872.17,2872.17,2791.58,2828.28,116311956.0,-56.08999999999969,56.08999999999969,0.0,29.83741476711116,2791.58,3186.72,9.287847345244796,-90.7121526547552,-8.536339161734759,29.62049557640984,-0.0921498639001592,1018841649.0,0
214,2010-11-24,2794.86,2861.49,2794.86,2859.94,116156238.0,31.65999999999985,0.0,31.65999999999985,36.8528468655235,2791.58,3186.72,17.30019739839048,-82.69980260160952,-13.907678397212749,20.91486078168532,-0.091430677247803,1134997887.0,1
215,2010-11-25,2875.86,2901.68,2856.96,2898.26,131608453.0,38.32000000000016,0.0,38.32000000000016,44.59028603331292,2791.58,3186.72,26.998026016095643,-73.00197398390435,-14.90063462136959,13.751761701074336,-0.0292017257087732,1266606340.0,1
216,2010-11-26,2890.29,2894.42,2851.96,2871.7,110866191.0,-26.5600000000004,26.5600000000004,0.0,40.61072899204634,2791.58,3186.72,20.27635774662143,-79.72364225337857,-17.62753030199383,7.475903300460701,-0.047342597722274,1155740149.0,0
217,2010-11-29,2861.15,2878.83,2841.79,2866.36,102452542.0,-5.339999999999691,5.339999999999691,0.0,39.7869769369092,2791.58,3186.72,18.92493799665947,-81.07506200334053,-19.98908637823706,1.9829053647211476,-0.0097355711097445,1053287607.0,0
218,2010-11-30,2863.41,2881.16,2758.92,2820.18,139324863.0,-46.18000000000029,46.18000000000029,0.0,33.08956051122959,2758.92,3186.72,14.319775596072883,-85.68022440392711,-25.29538699647992,-3.4727531075190683,-0.0065801060989271,913962744.0,0
219,2010-12-01,2810.54,2834.2,2795.81,2823.45,81263296.0,3.269999999999982,0.0,3.269999999999982,33.99731765875869,2758.92,3150.15,16.494133885438167,-83.50586611456183,-28.903623817953303,-8.558927249605917,-0.0146573836570171,995226040.0,1
220,2010-12-02,2860.46,2870.81,2841.47,2843.61,104195755.0,20.16000000000031,0.0,20.16000000000031,39.80651298562096,2758.92,3016.13,32.926402550445175,-67.07359744955482,-29.792998891856318,-12.805741578056,-0.0155647950369905,1099421795.0,1
221,2010-12-03,2846.73,2853.4,2822.74,2842.43,83521010.0,-1.180000000000291,1.180000000000291,0.0,39.57129310655227,2758.92,3007.64,33.57590865229971,-66.4240913477003,-30.244412418326647,-16.29347574611013,-0.0145404369064995,1015900785.0,0
222,2010-12-06,2850.38,2871.41,2831.7,2857.18,89773055.0,14.75,0.0,14.75,44.31699517194222,2758.92,2904.97,67.27832933926734,-32.72167066073266,-29.076780175894328,-18.85013663206697,0.0102182245039386,1105673840.0,1
223,2010-12-07,2843.77,2884.53,2809.11,2875.86,86785497.0,18.68000000000029,0.0,18.68000000000029,50.04932639204712,2758.92,2904.97,80.06846970215699,-19.931530297843015,-26.340466865377493,-20.34820267872908,0.0055665503472102,1192459337.0,1
224,2010-12-08,2868.73,2880.56,2843.94,2848.55,86707379.0,-27.309999999999945,27.309999999999945,0.0,42.64378093639062,2758.92,2904.97,61.3693940431361,-38.6306059568639,-26.07503082695439,-21.49356830837414,-0.0171516703125323,1105751958.0,0
225,2010-12-09,2837.61,2854.7,2808.51,2810.95,94622552.0,-37.60000000000037,37.60000000000037,0.0,34.52778856170917,2758.92,2904.97,35.62478603218065,-64.37521396781935,-28.56934689075661,-22.908724024850635,-0.0211547167183201,1011129406.0,0
226,2010-12-10,2798.74,2850.42,2792.52,2841.04,80496108.0,30.090000000000146,0.0,30.090000000000146,44.31399241959756,2758.92,2901.68,57.52311571868872,-42.47688428131127,-27.79766469576998,-23.886512159034503,-0.0088335031189383,1091625514.0,1
227,2010-12-13,2850.32,2923.77,2847.66,2922.95,128878468.0,81.90999999999985,0.0,81.90999999999985,62.105035119041865,2758.92,2923.77,99.50257810130412,-0.4974218986958836,-20.34215697003856,-23.17764112123532,0.0364409363941309,1220503982.0,1
228,2010-12-14,2928.3,2933.41,2912.42,2927.08,120944936.0,4.130000000000109,0.0,4.130000000000109,62.796546931957,2758.92,2933.41,96.372284944696,-3.627715055303992,-13.939669078879431,-21.330046712764144,0.0367033239476526,1341448918.0,1
229,2010-12-15,2927.26,2939.05,2905.65,2911.41,109462489.0,-15.670000000000073,15.670000000000073,0.0,58.15094768230038,2758.92,2939.05,84.65552656414795,-15.344473435852056,-10.014646701422862,-19.06696671049589,0.0238429320476436,1231986429.0,0
230,2010-12-16,2908.86,2921.27,2891.86,2898.14,87606313.0,-13.269999999999982,13.269999999999982,0.0,54.23080508915922,2758.92,2939.05,77.2886248820295,-22.711375117970512,-7.883935171412759,-16.830360402679265,0.019599427250627,1144380116.0,0
231,2010-12-17,2896.77,2898.81,2881.0,2893.74,73677136.0,-4.400000000000091,4.400000000000091,0.0,52.86728440321812,2758.92,2939.05,74.84594459556966,-25.15405540443034,-6.475726016394219,-14.759433525422256,0.0127958336541624,1070702980.0,0
232,2010-12-20,2901.47,2911.56,2804.56,2852.92,113755495.0,-40.81999999999971,40.81999999999971,0.0,41.65587582583058,2792.52,2939.05,41.22022793967106,-58.77977206032894,-8.554927044924625,-13.51853222932273,-0.0079767443477777,956947485.0,0
233,2010-12-21,2857.59,2908.17,2846.63,2904.11,106825623.0,51.190000000000055,0.0,51.190000000000055,55.35531952622628,2792.52,2939.05,76.15505357264723,-23.844946427352763,-6.002905946845203,-12.015406972827224,0.0195046602657491,1063773108.0,1
234,2010-12-22,2910.73,2917.2,2867.05,2877.9,98325557.0,-26.21000000000004,26.21000000000004,0.0,48.61192697290394,2792.52,2939.05,58.26793148160786,-41.73206851839215,-6.025876216885081,-10.817500821638795,0.0238175705722265,965447551.0,0
235,2010-12-23,2874.2,2893.71,2849.84,2855.22,89002488.0,-22.68000000000029,22.68000000000029,0.0,43.34040542981375,2792.52,2939.05,42.78987238108219,-57.2101276189178,-7.784432660514085,-10.210887189413857,0.004991130008729,876445063.0,0
236,2010-12-24,2841.35,2853.49,2813.5,2835.16,81216848.0,-20.059999999999945,20.059999999999945,0.0,39.02186530077613,2792.52,2939.05,29.09984303555573,-70.90015696444428,-10.67373546672252,-10.303456844875589,-0.0300347251920148,795228215.0,0
237,2010-12-27,2842.81,2876.81,2774.54,2781.4,97807278.0,-53.75999999999976,53.75999999999976,0.0,29.830488127943227,2774.54,2939.05,4.169959272992595,-95.8300407270074,-17.10434319935257,-11.663634115770986,-0.0497697363925823,697420937.0,0
238,2010-12-28,2768.03,2775.15,2730.41,2732.99,84332632.0,-48.41000000000031,48.41000000000031,0.0,23.96533021717101,2730.41,2939.05,1.2365797546011903,-98.76342024539882,-25.80941368487493,-14.492790029591776,-0.0612830209417429,613088305.0,0
239,2010-12-29,2735.48,2753.02,2721.48,2751.53,63941278.0,18.54000000000042,0.0,18.54000000000042,30.04346329227208,2721.48,2939.05,13.811646826308849,-86.18835317369116,-30.85652688413484,-17.76553740050039,-0.050587618265508,677029583.0,1
240,2010-12-30,2751.97,2768.13,2724.54,2759.57,73172046.0,8.039999999999964,0.0,8.039999999999964,32.73405627676364,2721.48,2939.05,17.507009238406084,-82.49299076159392,-33.81780900318972,-20.975991721038252,-0.0463656029912845,750201629.0,1
241,2010-12-31,2759.16,2808.93,2758.13,2808.08,83350214.0,48.50999999999976,0.0,48.50999999999976,46.941031933509535,2721.48,2939.05,39.80328170244052,-60.196718297559485,-31.88277013357765,-23.157347403546137,-0.0157172300660376,833551843.0,1
242,2011-01-04,2825.33,2855.4,2810.11,2852.65,110072791.0,44.57000000000016,0.0,44.57000000000016,56.64783929511989,2721.48,2939.05,60.28864273567128,-39.71135726432873,-26.44793605658515,-23.815465134153943,-0.0177197144736253,943624634.0,1
243,2011-01-05,2833.12,2850.49,2824.3,2838.59,104415282.0,-14.059999999999944,14.059999999999944,0.0,53.11117288818295,2721.48,2921.27,58.616547374743554,-41.383452625256446,-23.01006962370593,-23.654386032064345,-0.013659265436603,839209352.0,0
244,2011-01-06,2838.44,2853.88,2816.95,2824.2,84705616.0,-14.390000000000327,14.390000000000327,0.0,49.46425800908826,2721.48,2917.2,52.48313917841811,-47.5168608215819,-21.202281732039864,-23.16396517205945,-0.0108643116817618,754503736.0,0
245,2011-01-07,2820.67,2868.0,2807.87,2838.8,113129568.0,14.600000000000364,0.0,14.600000000000364,53.22435852789628,2721.48,2917.2,59.94277539341931,-40.05722460658068,-18.37962989471316,-22.2070981165902,0.001283878158552,867633304.0,1
246,2011-01-10,2832.62,2847.36,2786.86,2791.81,90780872.0,-46.99000000000024,46.99000000000024,0.0,41.70165068482753,2721.48,2917.2,35.93398732883711,-64.06601267116288,-19.707186072391774,-21.707115707750518,0.00374271949378,776852432.0,0
247,2011-01-11,2783.48,2810.76,2770.34,2804.05,80553780.0,12.240000000000236,0.0,12.240000000000236,45.26326495749814,2721.48,2917.2,42.187819333742205,-57.8121806662578,-19.54630061975331,-21.274952690151075,0.0260008269331393,857406212.0,1
248,2011-01-12,2811.78,2828.47,2788.13,2821.3,79246117.0,17.25,0.0,17.25,50.20968597274554,2721.48,2893.71,57.95738256981952,-42.042617430180485,-17.821432528943205,-20.5842486579095,0.0253568014886262,936652329.0,1
249,2011-01-13,2830.53,2837.53,2810.87,2827.71,74886265.0,6.409999999999855,0.0,6.409999999999855,52.0669106572627,2721.48,2876.81,68.38987961115049,-31.6101203888495,-15.755607872600194,-19.61852050084764,0.0246922527785125,1011538594.0,1
250,2011-01-14,2817.05,2817.05,2780.44,2791.34,76753880.0,-36.36999999999989,36.36999999999989,0.0,41.84756757411147,2721.48,2876.81,44.975214060387664,-55.02478593961233,-16.85884372486953,-19.06658514565202,-0.0059613686219764,934784714.0,0
251,2011-01-17,2772.45,2780.94,2698.78,2706.66,92519113.0,-84.68000000000029,84.68000000000029,0.0,27.39994657022828,2698.78,2868.0,4.6566599692705735,-95.34334003072942,-24.286178414627106,-20.11050379944704,-0.0511769757944368,842265601.0,0
252,2011-01-18,2696.15,2715.41,2683.37,2708.98,60377276.0,2.320000000000164,0.0,2.320000000000164,28.1837441584844,2683.37,2868.0,13.870985213670645,-86.12901478632935,-29.64347848898069,-22.01709873735377,-0.0456599931656209,902642877.0,1
253,2011-01-19,2707.82,2759.6,2700.81,2758.1,78493169.0,49.11999999999989,0.0,49.11999999999989,43.171905418735626,2683.37,2868.0,40.47554568596652,-59.52445431403349,-29.58457139642041,-23.530593269167102,-0.0234048580128886,981136046.0,1
254,2011-01-20,2752.8,2752.8,2676.13,2677.65,86047191.0,-80.44999999999982,80.44999999999982,0.0,30.96083250001236,2676.13,2868.0,0.7922030541512393,-99.20779694584876,-35.618936802787175,-25.948261975891125,-0.0567669437790615,895088855.0,0
255,2011-01-21,2668.68,2746.18,2667.29,2715.29,95639038.0,37.63999999999987,0.0,37.63999999999987,40.106287449115705,2667.29,2868.0,23.915101390065264,-76.08489860993474,-36.938181082391566,-28.146245797191213,-0.0274087419989182,990727893.0,1
256,2011-01-24,2716.52,2736.11,2690.65,2695.72,87920807.0,-19.570000000000164,19.570000000000164,0.0,37.153711416851706,2667.29,2868.0,14.16471526082399,-85.835284739176,-39.11196869260493,-30.33939037627396,-0.0386334052531162,902807086.0,0
257,2011-01-25,2691.69,2701.04,2661.45,2677.43,69481412.0,-18.289999999999964,18.289999999999964,0.0,34.42106338616135,2661.45,2868.0,7.736625514403295,-92.2633744855967,-41.82838953828104,-32.63719020867538,-0.0509942225215327,833325674.0,0
258,2011-01-26,2677.17,2710.74,2676.77,2708.81,60750899.0,31.38000000000011,0.0,31.38000000000011,42.75593811844052,2661.45,2868.0,22.92907286371343,-77.07092713628657,-40.9767148264018,-34.305095132220664,-0.0420481591110828,894076573.0,1
259,2011-01-27,2690.82,2753.0,2677.21,2749.15,105569163.0,40.34000000000015,0.0,40.34000000000015,51.83598782169715,2661.45,2847.36,47.1733634554355,-52.82663654456451,-36.62447151307879,-34.76897040839229,-0.0151146044552079,999645736.0,1
260,2011-01-28,2741.31,2759.44,2733.29,2752.75,85427992.0,3.599999999999909,0.0,3.599999999999909,52.61001966094744,2661.45,2837.53,51.85143116765106,-48.14856883234894,-32.51004189184232,-34.3171847050823,0.0170283670649435,1085073728.0,1
261,2011-01-31,2751.53,2790.92,2748.54,2790.69,91502814.0,37.940000000000055,0.0,37.940000000000055,60.35719337862819,2661.45,2837.53,73.39845524761469,-26.601544752385305,-25.889448411238845,-32.631637446313604,0.0301626442424824,1176576542.0,1
262,2011-02-01,2795.07,2805.05,2785.3,2798.96,73350092.0,8.269999999999982,0.0,8.269999999999982,61.922783419082975,2661.45,2837.53,78.09518400726938,-21.904815992730622,-19.74762219912418,-30.05483439687572,0.0148145462456039,1249926634.0,1
263,2011-02-09,2778.7,2804.21,2764.87,2774.06,87257788.0,-24.90000000000009,24.90000000000009,0.0,54.45195326095373,2661.45,2817.05,72.37146529562973,-27.628534704370267,-16.69693075158466,-27.383253667817502,0.0360054525423412,1162668846.0,0
264,2011-02-10,2769.65,2819.06,2760.18,2818.16,97919763.0,44.09999999999991,0.0,44.09999999999991,63.460723098361086,2661.45,2819.06,99.42897024300484,-0.5710297569951718,-10.598560753046968,-24.0263150848634,0.0378854560654662,1260588609.0,1
265,2011-02-11,2815.12,2835.41,2807.6,2827.33,107758171.0,9.170000000000073,0.0,9.170000000000073,65.11610920150426,2661.45,2835.41,95.35525408139809,-4.644745918601935,-4.968344250808514,-20.21472091805242,0.048821836095737,1368346780.0,1
266,2011-02-14,2828.57,2906.26,2828.57,2899.13,154242970.0,71.80000000000018,0.0,71.80000000000018,75.24737375333349,2661.45,2906.26,97.08753727380412,-2.9124627261958653,5.227048663371534,-15.12636700176763,0.0828032852399502,1522589750.0,1
267,2011-02-15,2900.43,2934.47,2892.64,2899.24,152449898.0,0.1099999999996725,0.0,0.1099999999996725,75.26007520209325,2661.45,2934.47,87.09618342978536,-12.903816570214644,13.16409953716584,-9.468273693980937,0.0703002425419279,1675039648.0,1
268,2011-02-16,2893.68,2924.19,2882.55,2923.9,127805697.0,24.66000000000031,0.0,24.66000000000031,78.15909334250352,2661.45,2934.47,96.12848875540264,-3.871511244597359,21.199747945869603,-3.334669366010825,0.0635651019405998,1802845345.0,1
269,2011-02-17,2929.25,2939.28,2905.03,2926.96,130415498.0,3.059999999999945,0.0,3.059999999999945,78.51948400350028,2661.45,2939.28,95.56563366087173,-4.434366339128297,27.49799387321264,2.831863281833869,0.0632858051039868,1933260843.0,1
270,2011-02-18,2924.23,2924.23,2890.26,2899.79,113775463.0,-27.170000000000076,27.170000000000076,0.0,67.1651207533002,2661.45,2939.28,85.78627218082994,-14.21372781917006,29.95174217837439,8.255839061141975,0.0390942741759205,1819485380.0,0
271,2011-02-21,2886.54,2932.82,2884.19,2932.25,118855883.0,32.46000000000004,0.0,32.46000000000004,72.62251868779055,2676.77,2939.28,97.322006780694,-2.677993219306005,34.122265866410544,13.42912442219569,0.0476212593248921,1938341263.0,1
272,2011-02-22,2941.32,2944.41,2851.62,2855.52,153004622.0,-76.73000000000002,76.73000000000002,0.0,49.969725792352826,2677.21,2944.41,66.73278443113774,-33.267215568862255,30.88000077300785,16.919299692358123,0.0293649019848165,1785336641.0,0
273,2011-02-23,2844.99,2868.48,2839.2,2862.63,111083059.0,7.110000000000127,0.0,7.110000000000127,51.58441139465362,2733.29,2944.41,61.26373626373637,-38.73626373626364,28.555035234797742,19.246446800846048,0.0157797995855453,1896419700.0,1
274,2011-02-24,2861.39,2881.54,2854.56,2878.6,109772588.0,15.9699999999998,0.0,15.9699999999998,55.321527799467766,2748.54,2944.41,66.40118445908001,-33.59881554091999,27.682027644426853,20.93356296956221,0.0181337162623393,2006192288.0,1
275,2011-02-25,2876.78,2890.32,2848.65,2878.56,100094039.0,-0.0399999999999636,0.0399999999999636,0.0,55.309189602853685,2760.18,2944.41,64.25663572708034,-35.74336427291966,26.67939175286756,22.082728726223284,-0.0070952320178813,1906098249.0,0
276,2011-02-28,2880.17,2906.17,2861.82,2905.05,118705763.0,26.49000000000024,0.0,26.49000000000024,61.816520565374965,2760.18,2944.41,78.63540140042356,-21.36459859957644,27.702974551792067,23.206777891337044,0.0020039734551124,2024804012.0,1
277,2011-03-01,2906.28,2931.58,2901.55,2918.92,136555048.0,13.86999999999989,0.0,13.86999999999989,64.90387338608872,2760.18,2944.41,86.16403408782513,-13.83596591217488,29.295662219321,24.42455475693384,-0.0017032046239611,2161359060.0,1
278,2011-03-02,2905.51,2924.96,2883.57,2913.81,133442258.0,-5.110000000000127,5.110000000000127,0.0,62.74713720191591,2807.6,2944.41,77.63321394634902,-22.36678605365099,29.80200540947817,25.50004488744271,-0.004492715992019,2027916802.0,0
279,2011-03-03,2918.73,2937.56,2900.76,2902.98,150488884.0,-10.829999999999927,10.829999999999927,0.0,58.03144694398411,2828.57,2944.41,64.2351519337017,-35.7648480662983,28.995157420218675,26.199067393997904,0.001100079660941,1877427918.0,0
280,2011-03-04,2902.19,2944.46,2898.08,2942.31,118277241.0,39.32999999999993,0.0,39.32999999999993,68.08271215044454,2839.2,2944.46,97.95743872316162,-2.0425612768383874,31.17001831153584,27.19325757750549,0.003430812515986,1995705159.0,1
281,2011-03-07,2952.72,3000.43,2952.72,2996.21,160105884.0,53.90000000000009,0.0,53.90000000000009,76.84992958653004,2839.2,3000.43,97.38262110029164,-2.6173788997083665,36.81847036660747,29.118300135325885,0.0492694850675183,2155811043.0,1
282,2011-03-08,2996.73,3001.62,2976.6,2999.94,126681154.0,3.730000000000018,0.0,3.730000000000018,77.34678902068681,2839.2,3001.62,98.96564462504628,-1.0343553749537222,41.1218619154115,31.519012491343013,0.0479663805661227,2282492197.0,1
283,2011-03-09,3002.55,3012.04,2989.34,3002.15,124790735.0,2.2100000000000364,0.0,2.2100000000000364,77.67436822987196,2839.2,3012.04,94.27794492015744,-5.722055079842551,44.201136069907534,34.055437207055924,0.0429201695268532,2407282932.0,1
284,2011-03-10,2995.77,2995.77,2954.37,2957.14,123799889.0,-45.01000000000022,45.01000000000022,0.0,57.9736570737415,2839.2,3012.04,68.23651932423047,-31.76348067576952,42.51941484068993,35.74823273378273,0.0272983714079262,2283483043.0,0
285,2011-03-11,2942.42,2966.98,2927.68,2933.8,115994480.0,-23.33999999999969,23.33999999999969,0.0,50.33504613343591,2839.2,3012.04,54.73270076371227,-45.26729923628773,38.85539490554538,36.36966516813526,0.0098965594395965,2167488563.0,0
286,2011-03-14,2923.98,2939.65,2914.46,2937.63,116910618.0,3.8299999999999272,0.0,3.8299999999999272,51.543911339028014,2839.2,3012.04,56.9486230039344,-43.051376996065606,35.84745455849361,36.26522304620693,0.0064099050333685,2284399181.0,1
287,2011-03-15,2927.98,2927.98,2850.95,2896.26,154951951.0,-41.36999999999989,41.36999999999989,0.0,39.546860339404624,2848.65,3012.04,29.138870187894096,-70.8611298121059,29.782117198317792,34.96860187662911,-0.0060230419965611,2129447230.0,0
288,2011-03-16,2894.25,2934.02,2894.25,2930.8,130777237.0,34.539999999999964,0.0,34.539999999999964,50.61921196158023,2848.65,3012.04,50.27847481486024,-49.72152518513976,27.446002545787906,33.46408201046087,0.0095832558267712,2260224467.0,1
289,2011-03-17,2906.96,2935.62,2885.65,2897.3,137797827.0,-33.5,33.5,0.0,42.00867274721068,2850.95,3012.04,28.77273573778653,-71.22726426221348,22.630573658455432,31.29738034005978,-0.0152975043418265,2122426640.0,0
290,2011-03-18,2920.81,2930.61,2900.87,2906.89,100637335.0,9.58999999999969,0.0,9.58999999999969,45.09369898990449,2850.95,3012.04,34.72592960456888,-65.27407039543112,19.364917707753197,28.910887813598467,-0.0298109945564564,2223063975.0,1
291,2011-03-21,2913.91,2927.07,2895.15,2909.14,96760275.0,2.25,0.0,2.25,45.87320584194354,2850.95,3012.04,36.12266434912161,-63.87733565087839,16.765159709791078,26.48174219283699,-0.0302672720121069,2319824250.0,1
292,2011-03-22,2917.69,2923.39,2884.75,2919.14,95117457.0,10.0,0.0,10.0,49.54648998670037,2850.95,3012.04,42.33037432491153,-57.66962567508847,15.334977121982774,24.25238917866615,-0.0276501840347751,2414941707.0,1
293,2011-03-23,2919.02,2950.42,2911.63,2948.48,112603475.0,29.340000000000146,0.0,29.340000000000146,58.97245398089391,2850.95,3012.04,60.54379539387927,-39.45620460612073,16.380218944632816,22.677955131859484,-0.0029285052449326,2527545182.0,1
294,2011-03-24,2949.85,2958.66,2942.13,2946.71,108955979.0,-1.7699999999999818,1.7699999999999818,0.0,58.21538882624843,2850.95,3012.04,59.44503072816446,-40.55496927183554,16.871274857609478,21.516619077009484,0.0044004362942258,2418589203.0,0
295,2011-03-25,2948.54,2985.08,2946.7,2977.81,136396367.0,31.09999999999991,0.0,31.09999999999991,66.84463565197842,2850.95,3012.04,78.75100875287107,-21.248991247128927,19.544651713830262,21.122225604373643,0.0136776925616908,2554985570.0,1
296,2011-03-28,2985.36,3005.78,2979.2,2984.0,156016878.0,6.190000000000055,0.0,6.190000000000055,68.3459247255322,2850.95,3012.04,82.59358122788507,-17.40641877211493,21.91023584084951,21.279827651668818,0.0302942415390883,2711002448.0,1
297,2011-03-29,2979.86,2994.17,2953.54,2958.08,168543246.0,-25.920000000000076,25.920000000000076,0.0,56.07743937970934,2850.95,3005.78,69.19201705095902,-30.807982949040984,21.44623211332282,21.313108543999626,0.0093080387607478,2542459202.0,0
298,2011-03-30,2955.45,2968.18,2935.75,2955.77,126493548.0,-2.309999999999945,2.309999999999945,0.0,55.06107852902495,2850.95,3005.78,67.70005812826966,-32.29994187173035,20.65402141953928,21.18129111910756,0.0201808580402442,2415965654.0,0
299,2011-03-31,2954.65,2961.63,2914.38,2928.11,108935611.0,-27.65999999999985,27.65999999999985,0.0,44.03449693862949,2850.95,3005.78,49.835303235807096,-50.1646967641929,17.591474335772546,20.46332776244056,0.0072998978289513,2307030043.0,0
300,2011-04-01,2932.48,2967.85,2924.39,2967.41,99844094.0,39.29999999999973,0.0,39.29999999999973,57.86714557260101,2850.95,3005.78,75.21798101143173,-24.782018988568268,18.12661295267344,19.995984800487136,0.0200299744941803,2406874137.0,1
301,2011-04-06,2964.21,3005.24,2963.9,3001.36,141650613.0,33.95000000000027,0.0,33.95000000000027,66.1954290123338,2884.75,3005.78,96.34801288936622,-3.651987110633782,21.047572120095083,20.206302264408727,0.0281658296621609,2548524750.0,1
302,2011-04-07,3003.2,3012.29,2990.31,3007.91,124734591.0,6.549999999999727,0.0,6.549999999999727,67.62024129594052,2884.75,3012.29,96.5657832836756,-3.4342167163243773,23.61872164301849,20.88878614013068,0.0201561482526588,2673259341.0,1
303,2011-04-08,3005.37,3031.1,2998.34,3030.02,114337794.0,22.110000000000127,0.0,22.110000000000127,72.18625345850688,2884.75,3031.1,99.26204304748894,-0.7379569525110543,27.12775649256446,22.13658021061744,0.0282722086666145,2787597135.0,1
304,2011-04-11,3037.91,3059.57,3019.89,3022.75,147189576.0,-7.269999999999982,7.269999999999982,0.0,68.52038541453841,2884.75,3059.57,78.93833657476253,-21.061663425237462,28.98790907850571,23.506845984195092,0.0150916277398491,2640407559.0,0
305,2011-04-12,3012.79,3039.12,3003.45,3021.37,145990547.0,-1.3800000000001091,1.3800000000001091,0.0,67.76662939511974,2884.75,3059.57,78.14895320901485,-21.851046790985148,30.00486157087107,24.80644910153029,0.0125234584450402,2494417012.0,0
306,2011-04-13,3006.83,3050.4,2994.47,3050.4,128202655.0,29.0300000000002,0.0,29.0300000000002,74.55948954459853,2911.63,3059.57,93.80154116533726,-6.198458834662747,32.77546695284991,26.400252671794224,0.0312094331458243,2622619667.0,1
307,2011-04-14,3049.67,3058.24,3036.73,3042.64,129487107.0,-7.760000000000218,7.760000000000218,0.0,70.00894788020918,2914.38,3059.57,88.3394173152419,-11.6605826847581,33.95362824128733,27.91092778569285,0.0293899728327982,2493132560.0,0
308,2011-04-15,3036.34,3062.53,3020.16,3050.53,128530989.0,7.890000000000327,0.0,7.890000000000327,72.01287380502663,2914.38,3062.53,91.9001012487344,-8.099898751265604,35.11915485480404,29.35257319951509,0.041808538613645,2621663549.0,1
309,2011-04-18,3040.53,3067.46,3037.19,3057.33,137488739.0,6.799999999999727,0.0,6.799999999999727,73.75664362345275,2914.38,3067.46,93.38254507447078,-6.617454925529209,36.1745485849724,30.716968276606558,0.0303025197057367,2759152288.0,1
310,2011-04-19,3038.81,3038.81,2996.22,2999.04,141896394.0,-58.28999999999997,58.28999999999997,0.0,45.63414845927159,2914.38,3067.46,55.30441599163829,-44.69558400836171,31.93926391692821,30.96142740467089,-0.0007729829144121,2617255894.0,0
311,2011-04-20,3005.98,3019.12,2992.67,3007.04,119741657.0,8.0,0.0,8.0,48.72986377029467,2914.38,3067.46,60.530441599163765,-39.46955840083623,28.89521736596544,30.5481853969298,-0.0002892373774481,2736997551.0,1
312,2011-04-21,3021.77,3035.47,3012.54,3026.67,121510664.0,19.63000000000011,0.0,19.63000000000011,55.84795942449113,2914.38,3067.46,73.35380193362948,-26.646198066370516,27.74691630899588,29.987931579343016,-0.0011056032633447,2858508215.0,1
313,2011-04-22,3025.7,3032.97,3004.47,3010.52,118525613.0,-16.15000000000009,16.15000000000009,0.0,49.3445820323382,2924.39,3067.46,60.20130006290629,-39.79869993709372,25.242726975977348,29.038890658669885,-0.004045984616657,2739982602.0,0
314,2011-04-25,3003.03,3003.61,2964.64,2964.95,117316622.0,-45.57000000000016,45.57000000000016,0.0,35.779547585245425,2963.9,3067.46,1.0139049826185087,-98.98609501738149,19.35787519691985,27.10268756631988,-0.018673648047078,2622665980.0,0
315,2011-04-26,2956.95,2970.28,2931.5,2938.98,95154819.0,-25.9699999999998,25.9699999999998,0.0,30.30192107483656,2931.5,3067.46,5.501618122977358,-94.49838187702264,12.454952860709,24.1731406251977,-0.0365263571990558,2527511161.0,0
316,2011-04-27,2946.33,2961.13,2907.66,2925.41,105492475.0,-13.570000000000164,13.570000000000164,0.0,27.741327690356627,2907.66,3067.46,11.10763454317896,-88.89236545682104,5.822236467855873,20.50295979372933,-0.0385290405700312,2422018686.0,0
317,2011-04-28,2937.95,2953.19,2884.84,2887.04,105230875.0,-38.36999999999989,38.36999999999989,0.0,21.746034922227963,2884.84,3067.46,1.204687328879542,-98.79531267112046,-2.5015411785316246,15.902059599277145,-0.0535939656387579,2316787811.0,0
318,2011-04-29,2886.63,2913.56,2871.01,2911.51,87534255.0,24.47000000000025,0.0,24.47000000000025,32.48310295723762,2871.01,3067.46,20.61593280733013,-79.38406719266987,-7.042489007749737,11.313149877871767,-0.0476952111809977,2404322066.0,1
319,2011-05-03,2911.51,2933.46,2890.23,2932.19,96402722.0,20.67999999999984,0.0,20.67999999999984,40.45058873345589,2871.01,3067.46,31.142784423517377,-68.85721557648262,-8.870268771323936,7.276466148032626,-0.0222904662825437,2500724788.0,1
320,2011-05-04,2916.84,2916.97,2860.07,2866.02,111481131.0,-66.17000000000007,66.17000000000007,0.0,28.17521806237771,2860.07,3067.46,2.8689907902983856,-97.13100920970162,-15.47972278803445,2.7252283608192096,-0.0468966159412578,2389243657.0,0
321,2011-05-05,2854.77,2880.12,2849.91,2872.4,91084427.0,6.380000000000109,0.0,6.380000000000109,30.52091190991102,2849.91,3067.46,10.33785336704216,-89.66214663295784,-19.9727169858852,-1.8143607085216733,-0.0509702081825901,2480328084.0,1
322,2011-05-06,2842.76,2881.71,2834.46,2863.89,91063909.0,-8.510000000000218,8.510000000000218,0.0,29.06023897537329,2834.46,3067.46,12.63090128755358,-87.36909871244643,-23.944120223666687,-6.240312611550678,-0.048705871410919,2389264175.0,0
323,2011-05-09,2868.24,2885.18,2861.42,2872.46,81576155.0,8.570000000000164,0.0,8.570000000000164,32.797391116043144,2834.46,3038.81,18.59554685588452,-81.40445314411548,-26.099104296311,-10.212070948502744,-0.031194455218469,2470840330.0,1
324,2011-05-10,2876.98,2891.03,2865.1,2890.63,81297176.0,18.170000000000076,0.0,18.170000000000076,40.46946622853751,2834.46,3035.47,27.943883388886192,-72.05611661111381,-26.040597751576115,-13.37777630911742,-0.0164512858202505,2552137506.0,1
325,2011-05-11,2890.35,2897.14,2868.35,2883.42,92477122.0,-7.210000000000036,7.210000000000036,0.0,38.45919284572821,2834.46,3035.47,24.35699716432023,-75.64300283567977,-26.2731570370147,-15.956852454696875,-0.0143535436058535,2459660384.0,0
326,2011-05-12,2864.98,2876.45,2843.1,2844.08,100240961.0,-39.34000000000015,39.34000000000015,0.0,29.297026256638887,2834.46,3032.97,4.846103470857842,-95.15389652914216,-29.294186026574607,-18.624319169072425,-0.0148802926180448,2359419423.0,0
327,2011-05-13,2846.31,2871.99,2832.25,2871.03,93238815.0,26.950000000000276,0.0,26.950000000000276,40.501172021374416,2832.25,3003.61,22.630718954248465,-77.36928104575153,-29.177394653440388,-20.73493426594602,-0.0139034384219872,2452658238.0,1
328,2011-05-16,2864.38,2877.09,2846.31,2849.07,84648251.0,-21.96000000000004,21.96000000000004,0.0,35.249311522143,2832.25,2970.28,12.18575671955382,-87.81424328044618,-30.50518039067265,-22.68898349089135,-0.0283474126847168,2368009987.0,0
329,2011-05-17,2846.45,2869.23,2821.2,2852.77,94819847.0,3.699999999999818,0.0,3.699999999999818,36.841500772879456,2821.2,2961.13,22.56128064032023,-77.43871935967978,-30.90267428291372,-24.331721649295822,-0.0046231359167068,2462829834.0,1
330,2011-05-18,2846.73,2877.43,2843.68,2872.77,76826970.0,20.0,0.0,20.0,45.23980262816372,2821.2,2953.19,39.071141753163175,-60.928858246836825,-29.266492297839704,-25.318675779004604,0.0001288121431555,2539656804.0,1
331,2011-05-19,2879.39,2884.14,2856.83,2859.57,76994538.0,-13.199999999999818,13.199999999999818,0.0,41.07991971483319,2821.2,2933.46,34.179583110636266,-65.82041688936373,-28.70405350841065,-25.995751324885813,-0.0015084378240783,2462662266.0,0
332,2011-05-20,2858.31,2866.76,2850.45,2858.46,70743786.0,-1.110000000000127,1.110000000000127,0.0,40.71664982962065,2821.2,2933.46,33.190807055050904,-66.80919294494909,-28.024831624858507,-26.40156738488035,-0.004873871176622,2391918480.0,0
333,2011-05-23,2853.29,2853.29,2771.12,2774.57,98622045.0,-83.88999999999987,83.88999999999987,0.0,22.988911302225645,2771.12,2916.97,2.36544394926313,-97.63455605073686,-33.86538619895691,-27.894331147695667,-0.0401504170371164,2293296435.0,0
334,2011-05-24,2766.06,2771.75,2744.78,2767.06,74852898.0,-7.510000000000218,7.510000000000218,0.0,21.9995111335692,2744.78,2897.14,14.623260698345886,-85.37673930165411,-38.65447726186176,-30.046360370528884,-0.0403548563858197,2218443537.0,0
335,2011-05-25,2764.56,2771.18,2737.33,2741.74,74406534.0,-25.320000000000164,25.320000000000164,0.0,18.84444418583567,2737.33,2897.14,2.759526938239069,-97.24047306176094,-43.98593633094242,-32.834275562611595,-0.0359835166380693,2144037003.0,0
336,2011-05-26,2755.39,2764.89,2734.54,2736.53,78741315.0,-5.209999999999582,5.209999999999582,0.0,18.22391922014937,2734.54,2897.14,1.2238622386225324,-98.77613776137748,-48.0773537060777,-35.882891191304815,-0.0468472987046461,2065295688.0,0
337,2011-05-27,2739.39,2746.84,2708.55,2709.95,82521052.0,-26.580000000000386,26.580000000000386,0.0,15.264972683511118,2708.55,2897.14,0.7423511320852848,-99.25764886791472,-52.855331949194806,-39.27737934288282,-0.0488299690776289,1982774636.0,0
338,2011-05-30,2704.49,2728.06,2689.21,2706.36,65174388.0,-3.5899999999996908,3.5899999999996908,0.0,14.888246110804772,2689.21,2897.14,8.247968066176167,-91.75203193382384,-56.28280399779851,-42.67846427386596,-0.0513220483950686,1917600248.0,0
339,2011-05-31,2707.56,2744.93,2702.09,2743.47,67900383.0,37.10999999999967,0.0,37.10999999999967,34.24399762628968,2689.21,2884.14,27.83563330426297,-72.16436669573703,-55.36640399033058,-45.21605221715889,-0.045008824235842,1985500631.0,1
340,2011-06-01,2737.06,2744.56,2726.5,2743.57,68555501.0,0.1000000000003638,0.0,0.1000000000003638,34.290460479346734,2689.21,2884.14,27.886933771097404,-72.1130662289026,-54.00949339769477,-46.97474045326607,-0.0405655395741317,2054056132.0,1
341,2011-06-02,2715.32,2728.0,2676.54,2705.18,86021158.0,-38.39000000000033,38.39000000000033,0.0,26.116228617757,2676.54,2884.14,13.795761078998018,-86.20423892100199,-55.39334414820996,-48.658461192254855,-0.0536232796680731,1968034974.0,0
342,2011-06-03,2701.77,2732.43,2701.25,2728.02,67983945.0,22.840000000000146,0.0,22.840000000000146,36.506539186871855,2676.54,2884.14,24.797687861271697,-75.2023121387283,-54.02430021601822,-49.73162899700753,-0.0167773745120866,2036018919.0,1
343,2011-06-07,2720.97,2745.77,2717.31,2744.3,65021293.0,16.2800000000002,0.0,16.2800000000002,43.08891326213608,2676.54,2884.14,32.639691714836346,-67.36030828516365,-51.037336449022405,-49.99277048741051,-0.0082253366388873,2101040212.0,1
344,2011-06-08,2742.04,2754.12,2715.25,2750.29,74294661.0,5.989999999999782,0.0,5.989999999999782,45.488106116593855,2676.54,2884.14,35.525048169556854,-64.47495183044313,-47.637665845832544,-49.52174955909492,0.0031184576218021,2175334873.0,1
345,2011-06-09,2743.54,2747.33,2702.7,2703.34,83469268.0,-46.94999999999982,46.94999999999982,0.0,32.93224926931892,2676.54,2866.76,14.088949637262193,-85.91105036273781,-48.176526018869936,-49.25270485104993,-0.0121284984999251,2091865605.0,0
346,2011-06-10,2696.13,2707.74,2672.32,2705.14,73400294.0,1.7999999999997272,0.0,1.7999999999997272,33.741300867958145,2672.32,2853.29,18.135602586063847,-81.86439741393615,-47.90609993200314,-48.983383867240576,-0.0017749404970571,2165265899.0,1
347,2011-06-13,2687.65,2703.42,2669.4,2700.38,63069459.0,-4.759999999999764,4.759999999999764,0.0,32.5434349088747,2669.4,2771.75,30.268685881778257,-69.73131411822175,-47.528004280673485,-48.69230794992716,-0.0022096099558077,2102196440.0,0
348,2011-06-14,2696.22,2735.55,2691.67,2730.04,83097514.0,29.65999999999985,0.0,29.65999999999985,46.26027161783286,2669.4,2771.18,59.579485164079415,-40.42051483592059,-44.32410592957194,-47.81866754585612,-0.004895260381925,2185293954.0,1
349,2011-06-15,2717.68,2730.48,2705.07,2705.43,74856945.0,-24.610000000000127,24.610000000000127,0.0,38.72194016645786,2669.4,2764.89,37.731699654413895,-62.268300345586105,-43.272002025661095,-46.90933444181712,-0.0139015953666209,2110437009.0,0
350,2011-06-16,2685.63,2691.94,2663.12,2664.28,70927870.0,-41.14999999999964,41.14999999999964,0.0,29.45993583561487,2663.12,2754.12,1.2747252747256144,-98.72527472527436,-45.23719694964939,-46.57490694338358,-0.0151191417946309,2039509139.0,0
351,2011-06-17,2661.41,2675.03,2641.39,2642.82,64442633.0,-21.46000000000004,21.46000000000004,0.0,25.75323567221368,2641.39,2754.12,1.2685176971527463,-98.73148230284724,-47.973264802347785,-46.85457851517643,-0.0312314425847317,1975066506.0,0
352,2011-06-20,2635.83,2637.88,2610.99,2621.25,60059864.0,-21.570000000000164,21.570000000000164,0.0,22.473790840241307,2610.99,2754.12,7.168308530706498,-92.8316914692935,-51.29088759517299,-47.741840331175744,-0.0448383923040484,1915006642.0,0
353,2011-06-21,2628.02,2648.02,2618.81,2646.48,64821871.0,25.230000000000015,0.0,25.230000000000015,33.84364978901834,2610.99,2754.12,24.795640326975622,-75.20435967302438,-51.29300359986655,-48.45207298491391,-0.0377451105156183,1979828513.0,1
354,2011-06-22,2648.53,2657.73,2633.47,2649.32,58313802.0,2.840000000000145,0.0,2.840000000000145,35.08025851430445,2610.99,2754.12,26.779850485572805,-73.2201495144272,-50.48357307818833,-48.8583730035688,-0.0199826880821502,2038142315.0,1
355,2011-06-23,2640.66,2693.42,2630.34,2688.25,73772688.0,38.92999999999984,0.0,38.92999999999984,49.89399241521053,2610.99,2754.12,53.978900300426304,-46.0210996995737,-46.16856542641335,-48.32041148813772,-0.0062436694588818,2111915003.0,1
356,2011-06-24,2678.05,2759.71,2674.3,2746.21,125773628.0,57.96000000000004,0.0,57.96000000000004,64.0041548205356,2610.99,2759.71,90.92253899946208,-9.077461000537909,-37.6381341844135,-46.18395602739288,0.0169716854664898,2237688631.0,1
357,2011-06-27,2746.79,2769.04,2743.5,2758.23,101601018.0,12.019999999999982,0.0,12.019999999999982,66.27662033901962,2610.99,2769.04,93.1603922809238,-6.839607719076199,-29.56696287875229,-42.86055739766477,0.0103258560314134,2339289649.0,1
358,2011-06-28,2759.71,2763.28,2736.4,2759.2,88277450.0,0.9699999999998,0.0,0.9699999999998,66.47370176874207,2610.99,2769.04,93.7741221132552,-6.225877886744786,-22.82907125319116,-38.85426016877005,0.0198748442946223,2427567099.0,1
359,2011-06-29,2757.4,2759.23,2727.25,2728.48,88224197.0,-30.7199999999998,30.7199999999998,0.0,54.77596080091147,2610.99,2769.04,74.33723505219874,-25.662764947801264,-19.74053426731416,-35.031514988478875,0.0240965664269521,2339342902.0,0
360,2011-06-30,2729.99,2774.36,2729.99,2762.08,90967124.0,33.59999999999991,0.0,33.59999999999991,62.99434134844624,2610.99,2774.36,92.48332007100436,-7.5166799289956385,-14.415435098697344,-30.90829901052257,0.0451260396092052,2430310026.0,1
361,2011-07-01,2767.83,2778.67,2752.97,2759.36,92072878.0,-2.7199999999998,2.7199999999998,0.0,61.94289782459427,2610.99,2778.67,88.48401717557257,-11.515982824427429,-10.296050449795985,-26.78584929837725,0.0526886027658559,2338237148.0,0
362,2011-07-04,2770.94,2813.27,2770.94,2812.82,121962260.0,53.46000000000004,0.0,53.46000000000004,72.39284371915599,2610.99,2813.27,99.77753608859015,-0.2224639114098367,-2.6866630416870976,-21.966012047039214,0.0628532994770412,2460199408.0,1
363,2011-07-05,2812.72,2818.14,2799.11,2816.35,110124224.0,3.5299999999997453,0.0,3.5299999999997453,72.95856398156963,2610.99,2818.14,99.13589186579776,-0.864108134202251,3.5873204038871336,-16.855345556853948,0.0630463666148293,2570323632.0,1
364,2011-07-06,2811.81,2811.81,2780.73,2810.48,103104393.0,-5.869999999999891,5.869999999999891,0.0,70.19849972114419,2610.99,2818.14,96.30219647598366,-3.697803524016342,7.993691246957042,-11.885538196091748,0.0454682414209988,2467219239.0,0
365,2011-07-07,2813.19,2825.12,2793.89,2794.27,116512143.0,-16.210000000000036,16.210000000000036,0.0,62.64695648184505,2610.99,2825.12,85.59286414794755,-14.40713585205244,10.061774485864134,-7.496075659700571,0.0175004824831312,2350707096.0,0
366,2011-07-08,2797.03,2807.38,2784.13,2797.77,86211609.0,3.5,0.0,3.5,63.62190300705719,2618.81,2825.12,86.74325044835446,-13.25674955164554,11.84660580425816,-3.627539366908824,0.014335280234063,2436918705.0,1
367,2011-07-11,2789.45,2807.32,2780.67,2802.69,86063595.0,4.920000000000073,0.0,4.920000000000073,65.09941976205704,2630.34,2825.12,88.4844439880892,-11.515556011910803,13.50245249753698,-0.2015409940196623,0.0157618150188461,2522982300.0,1
368,2011-07-12,2783.72,2783.72,2752.19,2754.58,96674475.0,-48.11000000000013,48.11000000000013,0.0,44.64189064166653,2630.34,2825.12,63.7847828319129,-36.2152171680871,10.808059422500264,2.000379089284324,0.0095657655544478,2426307825.0,0
369,2011-07-13,2756.03,2797.27,2756.03,2795.48,91929128.0,40.90000000000009,0.0,40.90000000000009,57.68557686209792,2674.3,2825.12,80.34743402731738,-19.652565972682623,11.836576991373477,3.967618669702155,0.0120923362103921,2518236953.0,1
370,2011-07-14,2798.21,2811.7,2788.98,2810.44,104502080.0,14.960000000000036,0.0,14.960000000000036,61.51286267300633,2727.25,2825.12,85.0005108817821,-14.999489118217893,13.700896146571722,5.914274165076069,0.0185115389075727,2622739033.0,1
371,2011-07-15,2803.58,2821.34,2794.16,2820.17,107470064.0,9.730000000000018,0.0,9.730000000000018,63.95925119140903,2727.25,2825.12,94.9422703586392,-5.057729641360808,15.781591824899806,7.8877376970408175,0.0026130360279008,2730209097.0,1
372,2011-07-18,2821.36,2826.96,2807.11,2816.69,108108623.0,-3.480000000000018,3.480000000000018,0.0,62.324385294834144,2727.25,2826.96,89.7001303780965,-10.2998696219035,16.954312463762108,9.701052650385078,0.0001207236316509,2622100474.0,0
373,2011-07-19,2804.92,2809.31,2790.69,2796.98,92740884.0,-19.71000000000004,19.71000000000004,0.0,53.40357362629789,2729.99,2826.96,69.08322161493251,-30.916778385067484,16.10759145473685,10.982360411255431,-0.0048034499444934,2529359590.0,0
374,2011-07-20,2810.44,2817.28,2779.38,2794.21,84030616.0,-2.769999999999982,2.769999999999982,0.0,52.192159359440026,2752.19,2826.96,56.19901029824796,-43.80098970175205,15.039675092056314,11.79382334741561,-2.1472513393461234e-05,2445328974.0,0
375,2011-07-21,2795.9,2799.85,2763.42,2765.89,81760582.0,-28.320000000000164,28.320000000000164,0.0,41.17404479883051,2752.19,2826.96,18.32285676073268,-81.67714323926732,11.772450875233517,11.789548852979191,-0.0113947894215751,2363568392.0,0
376,2011-07-22,2769.86,2782.17,2763.8,2770.79,70211837.0,4.900000000000091,0.0,4.900000000000091,43.55303867318266,2752.19,2826.96,24.876287280994937,-75.12371271900507,9.469384028716377,11.325515888126631,-0.0113819223674398,2433780229.0,1
377,2011-07-25,2759.63,2759.63,2680.75,2688.75,111242249.0,-82.03999999999996,82.03999999999996,0.0,24.450537746317764,2680.75,2826.96,5.471581971137404,-94.5284180288626,1.0125722939396835,9.262927169289242,-0.0238983801523281,2322537980.0,0
378,2011-07-26,2685.75,2704.94,2677.12,2703.03,72881454.0,14.2800000000002,0.0,14.2800000000002,30.56684288579048,2677.12,2826.96,17.291777896423042,-82.70822210357696,-4.485528891927515,6.5132359570458895,-0.0330712435789202,2395419434.0,1
379,2011-07-27,2690.14,2726.8,2680.43,2723.49,80407781.0,20.45999999999958,0.0,20.45999999999958,38.762779075640616,2677.12,2826.96,30.946342765616556,-69.05365723438345,-7.109904135648776,3.788607938506957,-0.0309382160800445,2475827215.0,1
380,2011-07-28,2701.77,2712.09,2684.66,2708.78,78474915.0,-14.709999999999582,14.709999999999582,0.0,35.30553962988674,2677.12,2826.96,21.129204484783955,-78.87079551521605,-10.25846133074947,0.9791940846556706,-0.0394976189378654,2397352300.0,0
381,2011-07-29,2706.5,2721.53,2681.27,2701.73,75471655.0,-7.050000000000182,7.050000000000182,0.0,33.64605565297147,2677.12,2826.96,16.424185798184798,-83.5758142018152,-13.17076726616233,-1.8507981855079303,-0.0408138630804242,2321880645.0,0
382,2011-08-01,2697.57,2712.89,2688.53,2703.78,59000711.0,2.050000000000182,0.0,2.050000000000182,34.67623787057414,2677.12,2826.96,17.792311799252726,-82.20768820074727,-15.138861463237845,-4.508410841053915,-0.0333216540697466,2380881356.0,1
383,2011-08-02,2689.97,2689.97,2651.28,2679.26,69993181.0,-24.519999999999985,24.519999999999985,0.0,28.55726615599032,2651.28,2826.96,15.92668488160294,-84.07331511839706,-18.46430436450009,-7.299589545743151,-0.0411386402596797,2310888175.0,0
384,2011-08-03,2659.12,2688.06,2654.36,2678.49,63981610.0,-0.7700000000004366,0.7700000000004366,0.0,28.37583441025086,2651.28,2826.96,15.488387978141851,-84.51161202185816,-20.920713425437043,-10.023814321681932,-0.0315992320735821,2246906565.0,0
385,2011-08-04,2683.19,2698.81,2675.53,2684.04,58872111.0,5.550000000000182,0.0,5.550000000000182,31.97038679057526,2651.28,2826.96,18.64754098360644,-81.35245901639357,-22.164102707648,-12.451871998875149,-0.0313087603174545,2305778676.0,1
386,2011-08-05,2620.28,2644.58,2605.14,2626.42,78571833.0,-57.61999999999989,57.61999999999989,0.0,19.96661271731554,2605.14,2817.28,10.031111530121697,-89.96888846987831,-27.48215296912167,-15.457928192924452,-0.0231817759181776,2227206843.0,0
387,2011-08-08,2599.29,2614.19,2497.92,2526.82,110302496.0,-99.59999999999992,99.59999999999992,0.0,11.416893374842672,2497.92,2817.28,9.049348697394814,-90.9506513026052,-39.28082878116811,-20.22250831057319,-0.0651898055145522,2116904347.0,0
388,2011-08-09,2468.03,2537.41,2437.68,2526.07,103723892.0,-0.75,0.75,0.0,11.374574660834668,2437.68,2799.85,24.40566584753025,-75.59433415246974,-48.13698984438224,-25.805404617335004,-0.0724878740145914,2013180455.0,0
389,2011-08-10,2562.39,2579.16,2544.95,2549.18,100369343.0,23.109999999999676,0.0,23.109999999999676,21.694223222966627,2437.68,2782.17,32.36668698655982,-67.63331301344017,-52.68347512360242,-31.181018718588497,-0.0589195135817601,2113549798.0,1
390,2011-08-11,2508.86,2582.16,2505.01,2581.51,95597265.0,32.33000000000038,0.0,32.33000000000038,34.083702319942844,2437.68,2759.63,44.674638919086895,-55.32536108091311,-53.06612341787968,-35.55803965844674,-0.0444974146195215,2209147063.0,1
391,2011-08-12,2593.4,2605.45,2585.85,2593.17,97171206.0,11.659999999999854,0.0,11.659999999999854,38.15563098121852,2437.68,2726.8,53.780437188710586,-46.21956281128941,-51.83103449267992,-38.812638625293374,-0.0409093935157446,2306318269.0,1
392,2011-08-15,2598.14,2627.1,2584.41,2626.77,88676842.0,33.59999999999991,0.0,33.59999999999991,48.69381364871768,2437.68,2726.8,65.40190924183727,-34.59809075816273,-47.59236328925863,-40.56858355808643,-0.0195912304143682,2394995111.0,1
393,2011-08-16,2627.85,2636.36,2601.5,2608.17,85226861.0,-18.59999999999991,18.59999999999991,0.0,43.91420679056433,2437.68,2721.53,60.06341377488111,-39.936586225118894,-45.21286461661521,-41.49743976979219,-0.0262535981093824,2309768250.0,0
394,2011-08-17,2603.96,2617.17,2596.04,2601.26,70109146.0,-6.909999999999855,6.909999999999855,0.0,42.14109071138794,2437.68,2721.53,57.62902941694564,-42.370970583054365,-43.38456378059482,-41.87486457195271,-0.0308415671897586,2239659104.0,0
395,2011-08-18,2601.99,2603.49,2556.86,2559.47,70989277.0,-41.79000000000042,41.79000000000042,0.0,32.87760344404377,2437.68,2712.89,44.25347916136767,-55.74652083863234,-44.7913985810842,-42.45817137377902,-0.0254909725024939,2168669827.0,0
396,2011-08-19,2519.65,2538.27,2513.75,2534.36,70606801.0,-25.109999999999676,25.109999999999676,0.0,28.529627900348544,2437.68,2698.81,37.02370466817303,-62.97629533182696,-47.38625321302243,-43.4437877416277,0.0029839877791058,2098063026.0,0
397,2011-08-22,2534.57,2553.42,2507.78,2515.86,61214429.0,-18.5,18.5,0.0,25.64635642264965,2437.68,2698.81,29.93911078773035,-70.06088921226964,-50.355028172939,-44.82603582788997,-0.0040418515718091,2036848597.0,0
398,2011-08-23,2524.88,2554.18,2514.95,2554.02,60944193.0,38.159999999999854,0.0,38.159999999999854,40.06312878912793,2437.68,2698.81,44.55252173247045,-55.44747826752955,-49.06304242161514,-45.673437146635,0.0018986497618842,2097792790.0,1
399,2011-08-24,2562.41,2569.28,2536.26,2541.09,65462469.0,-12.929999999999836,12.929999999999836,0.0,37.24010372816463,2437.68,2644.58,49.98066698888365,-50.01933301111635,-48.52313287375,-46.24337629205801,-0.015657502779381,2032330321.0,0
400,2011-08-25,2546.4,2616.3,2545.05,2615.26,104537978.0,74.17000000000007,0.0,74.17000000000007,57.20103495711302,2437.68,2636.36,89.37990738876591,-10.620092611234083,-41.63046148583635,-45.32079333081368,0.0085185313727986,2136868299.0,1
401,2011-08-26,2602.21,2616.64,2593.24,2612.19,77850450.0,-3.070000000000164,3.070000000000164,0.0,56.34515440566904,2437.68,2636.36,87.83470907992749,-12.165290920072495,-36.000699441336565,-43.45677455291826,-0.0055505430623922,2059017849.0,0
402,2011-08-29,2595.47,2595.47,2570.84,2576.41,73696095.0,-35.7800000000002,35.7800000000002,0.0,46.90682417139672,2505.01,2636.36,54.35858393604849,-45.64141606395151,-34.03389784588671,-41.57219921151196,-0.0121771203564186,1985321754.0,0
403,2011-08-30,2592.6,2615.14,2563.69,2566.59,75910686.0,-9.819999999999707,9.819999999999707,0.0,44.54392011252247,2505.01,2636.36,46.88237533307954,-53.11762466692046,-32.88846756060957,-39.83545288133149,-0.0133281563549971,1909411068.0,0
404,2011-08-31,2566.53,2574.42,2545.1,2567.34,59169720.0,0.75,0.0,0.75,44.78901442899036,2507.78,2636.36,46.32135635402083,-53.67864364597917,-31.556424259488267,-38.17964715696285,0.003074855341145,1968580788.0,1
405,2011-09-01,2569.8,2584.8,2547.85,2556.04,57290927.0,-11.300000000000182,11.300000000000182,0.0,41.59326873306381,2507.78,2636.36,37.53305335199859,-62.46694664800141,-31.05460772146398,-36.75463926986307,0.0085544279423601,1911289861.0,0
406,2011-09-02,2551.56,2557.31,2517.62,2528.28,54436581.0,-27.759999999999764,27.759999999999764,0.0,34.59617466204102,2507.78,2636.36,15.943381552340965,-84.05661844765903,-32.52202088715467,-35.90811559332139,0.00493668169135,1856853280.0,0
407,2011-09-05,2510.1,2510.1,2478.2,2478.74,55031066.0,-49.54000000000042,49.54000000000042,0.0,25.69529825077157,2478.2,2617.17,0.3885730733251512,-99.61142692667484,-37.25299107808405,-36.17709069027392,-0.029475101996069,1801822214.0,0
408,2011-09-06,2465.56,2482.24,2459.54,2470.52,49223173.0,-8.2199999999998,8.2199999999998,0.0,24.48904032934665,2459.54,2616.64,6.989178866963733,-93.01082113303627,-41.190782639888766,-37.17982908019689,-0.0277715468558769,1752599041.0,0
409,2011-09-07,2480.94,2516.75,2475.22,2516.09,59665860.0,45.57000000000016,0.0,45.57000000000016,41.92762458746266,2459.54,2616.64,35.996180776575564,-64.00381922342443,-40.17132266534964,-37.77812779722744,-0.0379197479409313,1812264901.0,1
410,2011-09-08,2523.96,2524.38,2498.11,2498.94,55271952.0,-17.15000000000009,17.15000000000009,0.0,38.106163326464525,2459.54,2616.64,25.07956715467862,-74.92043284532139,-40.28289878027999,-38.27908199383796,-0.0433544267453746,1756992949.0,0
411,2011-09-09,2506.97,2528.42,2487.15,2497.75,51253380.0,-1.1900000000000546,1.1900000000000546,0.0,37.8301071184628,2459.54,2616.64,24.322087842138803,-75.67791215786119,-40.00618036570632,-38.62450166821163,-0.0305308549493286,1705739569.0,0
412,2011-09-13,2467.73,2477.08,2453.8,2471.3,49930919.0,-26.449999999999815,26.449999999999815,0.0,31.90279670704315,2453.8,2616.64,10.7467452714321,-89.2532547285679,-41.44343881165787,-39.18828909690088,-0.0371270830167653,1655808650.0,0
413,2011-09-14,2478.59,2485.93,2439.37,2484.83,54065977.0,13.529999999999744,0.0,13.529999999999744,37.667229231240526,2439.37,2616.64,25.644497094827123,-74.35550290517287,-41.01788985835401,-39.55420924919151,-0.0321383221544478,1709874627.0,1
414,2011-09-15,2482.86,2496.57,2477.65,2479.05,56003688.0,-5.779999999999745,5.779999999999745,0.0,36.15848554842484,2439.37,2616.64,22.38393411180701,-77.61606588819299,-40.67812483957323,-39.778992367267854,-0.0301208118808781,1653870939.0,0
415,2011-09-16,2490.18,2499.48,2475.76,2482.34,47986854.0,3.289999999999964,0.0,3.289999999999964,37.794901623878765,2439.37,2615.14,24.446720145645024,-75.55327985435497,-39.68590865859642,-39.76037562553357,-0.0181704558039458,1701857793.0,1
416,2011-09-19,2469.6,2469.6,2437.17,2437.79,48746822.0,-44.55000000000018,44.55000000000018,0.0,26.986937813356832,2437.17,2615.14,0.3483733213462334,-99.65162667865376,-42.01011639533954,-40.210323779494765,-0.016520490249078,1653110971.0,0
417,2011-09-20,2433.72,2460.03,2426.7,2447.75,46265892.0,9.960000000000036,0.0,9.960000000000036,32.00296815650768,2426.7,2584.8,13.314358001265106,-86.6856419987349,-42.5577991931259,-40.679818862221,-0.0092166831274387,1699376863.0,1
418,2011-09-21,2450.12,2517.67,2438.85,2512.96,86689276.0,65.21000000000004,0.0,65.21000000000004,55.23548440431907,2426.7,2584.8,54.56040480708414,-45.43959519291587,-37.29996891568726,-40.003848872914254,-0.0012439936568247,1786066139.0,1
419,2011-09-22,2491.21,2499.98,2442.46,2443.06,74695409.0,-69.90000000000009,69.90000000000009,0.0,38.82746361507141,2426.7,2557.31,12.525840287880031,-87.47415971211997,-38.33158372492153,-39.66939584331571,-0.0223614812680577,1711370730.0,0
420,2011-09-23,2411.83,2440.75,2400.14,2433.16,67302693.0,-9.900000000000093,9.900000000000093,0.0,37.02985173594781,2400.14,2528.42,25.740567508574934,-74.25943249142506,-39.49274537061956,-39.634065748776486,-0.0258592733460114,1644068037.0,0
421,2011-09-26,2416.23,2441.73,2384.64,2393.18,57425042.0,-39.98000000000002,39.98000000000002,0.0,30.458920563626396,2384.64,2528.42,5.939629990262868,-94.06037000973711,-43.14171537370885,-40.33559567376296,-0.0316108930522398,1586642995.0,0
422,2011-09-27,2410.99,2423.91,2395.16,2415.05,55231432.0,21.870000000000346,0.0,21.870000000000346,37.4632150213024,2384.64,2528.42,21.150368618723235,-78.84963138127677,-43.76433614110101,-41.021343767230576,-0.0280824040276396,1641874427.0,1
423,2011-09-28,2427.29,2430.27,2383.4,2392.06,55758447.0,-22.99000000000024,22.99000000000024,0.0,33.384645816427394,2383.4,2528.42,5.971590125499832,-94.02840987450016,-45.58736567519918,-41.9345481488243,-0.0350900546580343,1586115980.0,0
424,2011-09-29,2378.42,2387.54,2358.57,2365.34,59191239.0,-26.7199999999998,26.7199999999998,0.0,29.131493548616533,2358.57,2528.42,3.985869885192809,-96.0141301148072,-48.62766100048748,-43.27317071915694,-0.0471329471385869,1526924741.0,0
425,2011-09-30,2368.4,2377.54,2348.22,2359.22,48818372.0,-6.120000000000346,6.120000000000346,0.0,28.18261987744833,2348.22,2517.67,6.491590439657706,-93.5084095603423,-50.94370251174814,-44.80727707767518,-0.0322300116088752,1478106369.0,0
426,2011-10-10,2363.08,2368.15,2338.69,2344.79,41745306.0,-14.429999999999836,14.429999999999836,0.0,25.88850368432678,2338.69,2517.67,3.408202033746736,-96.59179796625328,-53.32882104607734,-46.51158587135562,-0.0420631191910938,1436361063.0,0
427,2011-10-11,2401.74,2412.38,2323.41,2348.52,63975806.0,3.730000000000018,0.0,3.730000000000018,27.64518069641757,2323.41,2517.67,12.925975496756974,-87.07402450324302,-54.29221794851628,-48.06771228678776,-0.0654367757544887,1500336869.0,1
428,2011-10-12,2335.49,2421.69,2318.63,2420.0,91508568.0,71.48000000000002,0.0,71.48000000000002,52.52679327622851,2318.63,2517.67,50.92946141479096,-49.07053858520905,-48.72619309488891,-48.19940844840799,-0.0094389822599526,1591845437.0,1
429,2011-10-13,2412.83,2439.64,2406.28,2438.79,87860106.0,18.789999999999964,0.0,18.789999999999964,57.010746814787794,2318.63,2517.67,60.36977491961408,-39.63022508038592,-42.31114578113648,-47.021755914953694,0.0023138634532871,1679705543.0,1
430,2011-10-14,2429.89,2437.59,2409.29,2431.38,60673160.0,-7.4099999999998545,7.4099999999998545,0.0,54.66147526759921,2318.63,2517.67,56.64690514469455,-43.35309485530546,-37.39404437257144,-45.09621360647725,0.0159620254222416,1619032383.0,0
431,2011-10-17,2434.49,2452.99,2424.73,2440.4,58267682.0,9.019999999999982,0.0,9.019999999999982,57.14200574450585,2318.63,2517.67,61.178657556270096,-38.821342443729904,-32.39592737870862,-42.55615636092353,0.0104966770874308,1677300065.0,1
432,2011-10-18,2423.28,2425.65,2378.67,2383.49,79525744.0,-56.91000000000031,56.91000000000031,0.0,40.865425520662576,2318.63,2499.98,35.76509511993366,-64.23490488006634,-32.65066845327601,-40.57505877939403,-0.0035826860530254,1597774321.0,0
433,2011-10-19,2387.83,2401.69,2374.42,2377.51,58534637.0,-5.979999999999563,5.979999999999563,0.0,39.50122335793753,2318.63,2452.99,43.82256623995255,-56.17743376004745,-32.95520156351131,-39.051087336217485,0.0051451376969062,1539239684.0,0
434,2011-10-20,2365.91,2368.64,2315.9,2331.37,65425215.0,-46.14000000000033,46.14000000000033,0.0,30.45117216473628,2315.9,2452.99,11.284557589904322,-88.71544241009568,-36.49892178875598,-38.54065422672519,-0.0118047490272208,1473814469.0,0
435,2011-10-21,2330.51,2340.31,2313.78,2317.27,48436725.0,-14.099999999999907,14.099999999999907,0.0,28.175054623275628,2313.78,2452.99,2.5070038071976093,-97.4929961928024,-39.9841849647878,-38.82936037433771,-0.0117366587199706,1425377744.0,0
436,2011-10-24,2322.02,2371.09,2307.15,2370.33,70874071.0,53.059999999999945,0.0,53.059999999999945,45.77423365353796,2307.15,2452.99,43.321448162369705,-56.678551837630295,-38.02643748202263,-38.66877579587469,0.0092866997087526,1496251815.0,1
437,2011-10-25,2366.4,2414.05,2357.39,2409.67,90888876.0,39.34000000000015,0.0,39.34000000000015,55.17122796995726,2307.15,2452.99,70.29621503017019,-29.70378496982981,-32.9210064059871,-37.51922191789718,-0.0042685950413222,1587140691.0,1
438,2011-10-26,2398.19,2448.98,2394.73,2427.48,107447168.0,17.809999999999945,0.0,17.809999999999945,58.89242443874517,2307.15,2452.99,82.50822819528263,-17.491771804717374,-27.12511588879761,-35.44040071207726,-0.0046375456681386,1694587859.0,1
439,2011-10-27,2432.47,2449.7,2426.31,2435.61,82408961.0,8.13000000000011,0.0,8.13000000000011,60.61444092515755,2307.15,2452.99,88.08283049917739,-11.917169500822608,-21.626510886568667,-32.677622746975544,0.0017397527330158,1776996820.0,1
440,2011-10-28,2462.08,2483.76,2456.18,2473.41,110032721.0,37.79999999999973,0.0,37.79999999999973,67.84148343547693,2307.15,2483.76,94.1396296925427,-5.860370307457311,-14.056646444519629,-28.95342748648436,0.0135264710703162,1887029541.0,1
441,2011-10-31,2470.25,2478.31,2455.21,2468.25,84172562.0,-5.159999999999855,5.159999999999855,0.0,65.9358003239482,2307.15,2483.76,91.21793782911487,-8.78206217088512,-8.377275198532516,-24.83819702889399,0.0355612987677733,1802856979.0,0
442,2011-11-01,2450.33,2491.35,2445.53,2470.02,88892417.0,1.7699999999999818,0.0,1.7699999999999818,66.31036185134126,2307.15,2491.35,88.42019543973944,-11.579804560260555,-3.690961257105755,-20.608749874536343,0.0389104567383522,1891749396.0,1
443,2011-11-02,2437.87,2505.12,2433.72,2504.11,105468200.0,34.090000000000146,0.0,34.090000000000146,72.92608937534544,2307.15,2505.12,99.4898216901552,-0.510178309844807,2.742144665744945,-15.938570966480086,0.0740937731891548,1997217596.0,1
444,2011-11-03,2510.84,2535.24,2507.3,2508.09,136576325.0,3.980000000000018,0.0,3.980000000000018,73.62383464053163,2307.15,2535.24,88.09680389320019,-11.903196106799804,8.068570734465993,-11.137142626290869,0.0823468995844247,2133793921.0,1
445,2011-11-04,2525.24,2536.78,2512.9,2528.29,101873675.0,20.199999999999815,0.0,20.199999999999815,77.08264397915018,2307.15,2536.78,96.3027478987936,-3.697252101206389,13.761143059139158,-6.157485489204863,0.0666405099711855,2235667596.0,1
446,2011-11-07,2518.9,2536.18,2507.61,2509.8,78867174.0,-18.48999999999978,18.48999999999978,0.0,67.70546624554996,2307.15,2536.78,88.25066411183208,-11.749335888167924,16.589327723095266,-1.608122846744836,0.0415534077280292,2156800422.0,0
447,2011-11-08,2514.26,2524.82,2500.02,2503.84,78672656.0,-5.960000000000036,5.960000000000036,0.0,64.7747191786259,2307.15,2536.78,85.65518442712188,-14.344815572878126,18.140648155276267,2.3416313536593854,0.0314564898577949,2078127766.0,0
448,2011-11-09,2512.59,2527.7,2489.02,2524.92,78208572.0,21.079999999999927,0.0,21.079999999999927,70.06321347060174,2307.15,2536.78,94.8351696206941,-5.164830379305893,20.83093455478865,6.039491993885241,0.03666843213815,2156336338.0,1
449,2011-11-10,2498.59,2507.45,2478.14,2479.54,87111088.0,-45.38000000000011,45.38000000000011,0.0,51.03214439393705,2307.15,2536.78,75.07294343073632,-24.92705656926369,19.081262251787397,8.647846045465673,0.0024783598352073,2069225250.0,0
450,2011-11-11,2483.96,2496.53,2472.76,2481.08,66137668.0,1.5399999999999636,0.0,1.5399999999999636,51.54748409587449,2357.39,2536.78,68.9503316795807,-31.049668320419293,17.61583509414504,10.441443855201548,0.005198014787805,2135362918.0,1
451,2011-11-14,2498.67,2529.63,2496.33,2528.71,81229812.0,47.63000000000011,0.0,47.63000000000011,64.77639487254353,2394.73,2536.78,94.31890179514244,-5.681098204857553,20.06650230574587,12.366455545310414,0.0237609412069537,2216592730.0,1
452,2011-11-15,2525.95,2534.06,2518.7,2529.76,79227750.0,1.050000000000182,0.0,1.050000000000182,65.01933121421129,2426.31,2536.78,93.6453335747262,-6.354666425273798,21.841623314199296,14.261489099088193,0.010243160244558,2295820480.0,1
453,2011-11-16,2529.07,2529.46,2456.86,2466.96,93382109.0,-62.80000000000018,62.80000000000018,0.0,44.05201930840642,2433.72,2536.78,32.25305647195819,-67.74694352804181,17.973793639178893,15.003950007106337,-0.0163989330526417,2202438371.0,0
454,2011-11-17,2467.7,2482.53,2459.17,2463.05,66414285.0,-3.9099999999998554,3.9099999999998554,0.0,43.054584140022726,2433.72,2536.78,28.459150009703343,-71.54084999029665,14.426704365140722,14.888500878713211,-0.0258040019143372,2136024086.0,0
455,2011-11-18,2448.39,2448.51,2411.04,2416.56,72180807.0,-46.49000000000024,46.49000000000024,0.0,32.85018618869523,2411.04,2536.78,4.390011134086187,-95.6099888659138,7.774634941149543,13.46572769120048,-0.037150370547454,2063843279.0,0
456,2011-11-21,2416.73,2419.24,2396.09,2415.13,50170366.0,-1.4299999999998363,1.4299999999998363,0.0,32.57615987161171,2396.09,2536.78,13.53330016347996,-86.46669983652005,2.360225734989399,11.244627299958264,-0.0354295801648667,2013672913.0,0
457,2011-11-22,2400.98,2414.85,2387.83,2412.62,51443233.0,-2.5100000000002183,2.5100000000002183,0.0,32.03495199729622,2387.83,2536.78,16.64316884860686,-83.35683115139314,-2.1089578394667114,8.573910272073269,-0.0444766566861525,1962229680.0,0
458,2011-11-23,2415.2,2418.56,2390.65,2395.06,50547850.0,-17.559999999999945,17.559999999999945,0.0,28.24676327968767,2387.83,2536.78,4.853977844914404,-95.1460221550856,-6.987218955185654,5.461684426621483,-0.0340708357195286,1911681830.0,0
459,2011-11-24,2379.15,2409.72,2370.7,2397.55,52154150.0,2.4900000000002365,0.0,2.4900000000002365,29.60867639609629,2370.7,2536.18,16.22552574329246,-83.77447425670755,-10.530959499351413,2.2631556414269034,-0.0336667902687538,1963835980.0,1
460,2011-11-25,2393.33,2403.94,2372.62,2380.22,45362552.0,-17.330000000000382,17.330000000000382,0.0,25.692506665272035,2370.7,2534.06,5.827619980411345,-94.17238001958866,-14.5698336066107,-1.1034422081806186,-0.0587216406784487,1918473428.0,0
461,2011-11-28,2383.89,2396.83,2372.16,2383.03,46064666.0,2.8100000000004,0.0,2.8100000000004,27.48688790981244,2370.7,2534.06,7.547747306562422,-92.45225269343756,-17.343996128177878,-4.351552992180071,-0.0580015495541078,1964538094.0,1
462,2011-11-29,2398.99,2413.33,2388.2,2412.39,55123190.0,29.359999999999676,0.0,29.359999999999676,43.83727152067603,2370.7,2534.06,25.520323212536745,-74.47967678746326,-16.977724643614692,-6.876787322466996,-0.0221203424457632,2019661284.0,1
463,2011-11-30,2406.33,2407.33,2319.44,2333.41,76611104.0,-78.98000000000002,78.98000000000002,0.0,25.788528808009687,2319.44,2534.06,6.509179014071292,-93.4908209859287,-22.79768032216316,-10.06096592240623,-0.0526339294776802,1943050180.0,0
464,2011-12-01,2392.49,2423.56,2376.92,2386.86,98650046.0,53.45000000000027,0.0,53.45000000000027,43.84303309267575,2319.44,2534.06,31.41366135495299,-68.58633864504701,-22.833854368636366,-12.61554361165226,-0.0122901976363093,2041700226.0,1
465,2011-12-02,2374.9,2378.3,2344.85,2359.35,59586442.0,-27.51000000000022,27.51000000000022,0.0,38.30828315732586,2319.44,2534.06,18.59565744105856,-81.40434255894145,-24.79651090796824,-15.05173707091546,-0.023096065222162,1982113784.0,0
466,2011-12-05,2363.11,2363.13,2327.61,2332.05,52038561.0,-27.299999999999727,27.299999999999727,0.0,33.470177081739095,2319.44,2529.46,6.004190077135572,-93.99580992286442,-28.22940123470471,-17.68726990367331,-0.0333952300818196,1930075223.0,0
467,2011-12-06,2326.66,2331.89,2310.16,2325.91,45917077.0,-6.140000000000327,6.140000000000327,0.0,32.40801981720536,2310.16,2482.53,9.137320879503376,-90.86267912049662,-31.08708566465839,-20.36723305587033,-0.0288719280519068,1884158146.0,0
468,2011-12-07,2325.56,2339.85,2317.81,2332.73,41570306.0,6.820000000000164,0.0,6.820000000000164,35.04967455746264,2310.16,2448.51,16.313697144922372,-83.68630285507763,-32.42769784579377,-22.77932601385502,-0.0270359325144419,1925728452.0,1
469,2011-12-08,2329.91,2346.65,2302.64,2329.82,51473520.0,-2.9099999999998545,2.9099999999998545,0.0,34.38800016558152,2302.64,2423.56,22.47767118756225,-77.52232881243775,-33.34062536268584,-24.891585883621183,-0.0211745132802848,1874254932.0,0
470,2011-12-09,2315.51,2331.26,2309.46,2315.27,39988559.0,-14.550000000000182,14.550000000000182,0.0,31.01055864447106,2302.64,2423.56,10.444922262653078,-89.55507773734692,-34.836615578340115,-26.880591822564973,-0.0284343881528978,1834266373.0,0
471,2011-12-12,2312.15,2315.81,2290.26,2291.54,39632578.0,-23.730000000000015,23.730000000000015,0.0,26.173086191010427,2290.26,2423.56,0.9602400600148148,-99.0397599399852,-37.50468066948406,-29.005409591948798,-0.0500955483980616,1794633795.0,0
472,2011-12-13,2283.22,2285.81,2257.17,2260.48,31133333.0,-31.059999999999945,31.059999999999945,0.0,21.18262843881942,2257.17,2423.56,1.989302241721226,-98.01069775827878,-41.64536208653999,-31.53340009086704,-0.0312546873459871,1763500462.0,0
473,2011-12-14,2241.39,2256.74,2231.41,2231.82,35320269.0,-28.65999999999985,28.65999999999985,0.0,17.608087488187607,2231.41,2423.56,0.2133749674734889,-99.78662503252652,-46.70116248923023,-34.56695257053968,-0.064955632085669,1728180193.0,0
474,2011-12-15,2215.79,2216.91,2183.19,2192.37,37442653.0,-39.45000000000027,39.45000000000027,0.0,13.886339680795558,2183.19,2423.56,3.8191122020218167,-96.1808877979782,-53.27706123789904,-38.30897430401155,-0.0707737300527687,1690737540.0,0
475,2011-12-16,2179.51,2225.54,2170.75,2224.84,57265903.0,32.470000000000255,0.0,32.470000000000255,28.282400872038775,2170.75,2423.56,21.39551441794239,-78.60448558205762,-55.23177323485743,-41.69353409018073,-0.0459724276923736,1748003443.0,1
476,2011-12-19,2208.07,2221.45,2164.89,2218.24,57818464.0,-6.600000000000364,6.600000000000364,0.0,27.215326388043863,2164.89,2423.56,20.62473421734252,-79.37526578265748,-56.66031655743336,-44.68689058363126,-0.0462915590027129,1690184979.0,0
477,2011-12-20,2209.7,2239.86,2206.52,2215.93,52761113.0,-2.309999999999945,2.309999999999945,0.0,26.806874791028307,2164.89,2423.56,19.731704488344203,-80.2682955116558,-57.31811754740147,-47.21313597638531,-0.0500700895517269,1637423866.0,0
478,2011-12-21,2230.18,2237.47,2188.71,2191.15,50877262.0,-24.779999999999745,24.779999999999745,0.0,22.60723755178165,2164.89,2378.3,12.304952907548934,-87.69504709245106,-59.15704290937174,-49.60191736298261,-0.0595196195414238,1586546604.0,0
479,2011-12-22,2178.57,2201.59,2149.42,2186.3,58986117.0,-4.849999999999909,4.849999999999909,0.0,21.83473167013051,2149.42,2363.13,17.257030555425626,-82.74296944457437,-60.31053664983938,-51.743641220353965,-0.0557040863484603,1527560487.0,0
480,2011-12-23,2183.91,2219.79,2178.14,2204.78,52421325.0,18.480000000000015,0.0,18.480000000000015,32.04391050726784,2149.42,2346.65,28.068752218222443,-71.93124778177756,-59.052783464737786,-53.20546966923074,-0.0378610017717342,1579981812.0,1
481,2011-12-26,2193.66,2213.45,2186.07,2190.11,43613663.0,-14.670000000000073,14.670000000000073,0.0,28.61999812109522,2149.42,2346.65,20.630735689296785,-79.36926431070322,-58.56465451954728,-54.27730663929405,-0.0311305563420157,1536368149.0,0
482,2011-12-27,2186.71,2196.97,2162.72,2166.21,45712179.0,-23.90000000000009,23.90000000000009,0.0,23.83292397360177,2149.42,2346.65,8.512903716473135,-91.48709628352688,-59.42136654802107,-55.30611862103947,-0.029397532059037,1490655970.0,0
483,2011-12-28,2157.65,2170.67,2134.02,2170.01,49633435.0,3.800000000000182,0.0,3.800000000000182,26.10056990478462,2134.02,2331.26,18.24680592171983,-81.75319407828016,-59.11227920226111,-56.0673507372838,-0.0101990083790599,1540289405.0,1
484,2011-12-29,2161.18,2181.96,2157.11,2173.56,44749200.0,3.549999999999727,0.0,3.549999999999727,28.398427879417056,2134.02,2315.81,21.75037130755265,-78.24962869244735,-57.913281661255496,-56.43653692207814,-0.0230488484565183,1585038605.0,1
485,2011-12-30,2177.52,2200.99,2177.52,2199.42,51943838.0,25.860000000000127,0.0,25.860000000000127,43.23438352184909,2134.02,2285.81,43.08584228210034,-56.91415771789966,-54.25100972273231,-55.999431482208976,-0.0084842036930177,1636982443.0,1
486,2012-01-04,2212.0,2217.52,2168.64,2169.39,49245537.0,-30.0300000000002,30.0300000000002,0.0,33.839496208225086,2134.02,2256.74,28.82170795306384,-71.17829204693615,-53.15901877690703,-55.4313489411486,-0.0210024684895281,1587736906.0,0
487,2012-01-05,2160.9,2183.4,2145.56,2148.45,58743447.0,-20.94000000000005,20.94000000000005,0.0,28.803584631373624,2134.02,2239.86,13.633786848072388,-86.36621315192761,-53.36809688172298,-55.018698529263474,-0.0194874837414144,1528993459.0,0
488,2012-01-06,2148.15,2164.32,2132.63,2163.4,50583054.0,14.950000000000273,0.0,14.950000000000273,36.57861910090836,2132.63,2239.86,28.69532780005593,-71.30467219994406,-51.73112848086112,-54.361184519583,-0.0104743173397978,1579576513.0,1
489,2012-01-09,2164.74,2226.22,2148.45,2225.89,76759839.0,62.48999999999978,0.0,62.48999999999978,58.45845559211832,2132.63,2239.86,86.97192949734193,-13.028070502658071,-44.8741175858172,-52.46377113282984,0.0095746514391457,1656336352.0,1
490,2012-01-10,2221.83,2288.63,2218.27,2285.74,109585415.0,59.84999999999991,0.0,59.84999999999991,69.92467493191963,2132.63,2288.63,98.14743589743568,-1.8525641025643125,-34.21607067276727,-48.81423104081733,0.0436644734739348,1765921767.0,1
491,2012-01-11,2282.91,2290.64,2265.19,2276.05,84441781.0,-9.6899999999996,9.6899999999996,0.0,66.49589229897809,2132.63,2290.64,90.76640718941856,-9.233592810581428,-26.248813738921854,-44.30114758043824,0.0507060718951533,1681479986.0,0
492,2012-01-12,2268.74,2295.22,2265.26,2275.01,71569994.0,-1.0399999999999636,1.0399999999999636,0.0,66.09453375712638,2132.63,2295.22,87.56996125222976,-12.430038747770231,-19.790492052986792,-39.39901647494796,0.0483868737932082,1609909992.0,0
493,2012-01-13,2277.08,2281.53,2225.74,2244.58,71474322.0,-30.43000000000029,30.43000000000029,0.0,54.90598199918914,2132.63,2295.22,68.85417307337477,-31.14582692662524,-16.93248512465607,-34.90571020488958,0.0326745063398294,1538435670.0,0
494,2012-01-16,2230.43,2241.26,2206.04,2206.19,45859522.0,-38.38999999999987,38.38999999999987,0.0,44.05101879820474,2132.63,2295.22,45.24263484839171,-54.75736515160828,-17.562793256309305,-31.437126815173524,0.003078084222204,1492576148.0,0
495,2012-01-17,2206.53,2298.38,2196.12,2298.38,87803560.0,92.19000000000004,0.0,92.19000000000004,63.8525851428415,2132.63,2298.38,100.0,-0.0,-10.502290587305197,-27.25015956959986,0.0594591106255677,1580379708.0,1
496,2012-01-18,2298.83,2311.58,2257.9,2266.38,89940422.0,-32.0,32.0,0.0,55.92521566579119,2132.63,2311.58,74.74154791841305,-25.25845208158696,-7.403580056463397,-23.280843666972565,0.0548907351811773,1490439286.0,0
497,2012-01-19,2266.08,2305.71,2259.34,2296.07,72498861.0,29.69000000000005,0.0,29.69000000000005,61.09596399013509,2132.63,2311.58,91.33277451802192,-8.667225481978083,-2.5230110644201886,-19.12927714646209,0.061324766571138,1562938147.0,1
498,2012-01-20,2300.5,2322.89,2293.89,2319.12,69922753.0,23.049999999999727,0.0,23.049999999999727,64.79567548222687,2132.63,2322.89,98.01850099863346,-1.981499001366544,3.168295252017288,-14.669762666766214,0.0418843698475666,1632860900.0,1
499,2012-01-30,2324.49,2324.49,2284.29,2285.04,58413687.0,-34.07999999999993,34.07999999999993,0.0,55.75083092145843,2132.63,2324.49,79.43813197122907,-20.56186802877092,4.872557519858219,-10.761298629441328,-0.0003062465547262,1574447213.0,0
500,2012-01-31,2285.95,2296.38,2277.06,2292.61,48738325.0,7.570000000000164,0.0,7.570000000000164,57.27923540533041,2132.63,2324.49,83.38371729386026,-16.616282706139742,6.75615265825445,-7.257808371902172,0.0072757628347355,1623185538.0,1
501,2012-02-01,2288.07,2305.86,2263.34,2268.08,53553811.0,-24.5300000000002,24.5300000000002,0.0,50.727902559188685,2132.63,2324.49,70.59835296570418,-29.401647034295813,6.1981015255646525,-4.566626392408806,-0.0030461404565256,1569631727.0,0
502,2012-02-02,2273.85,2312.56,2268.69,2312.56,63471872.0,44.48000000000002,0.0,44.48000000000002,60.24207997107344,2148.45,2324.49,93.22313110656678,-6.776868893433219,9.238510449803924,-1.8055990239662592,0.0302862896399327,1633103599.0,1
503,2012-02-03,2306.66,2336.27,2300.98,2330.41,78943697.0,17.84999999999991,0.0,17.84999999999991,63.50512746694481,2196.12,2336.27,95.81876560827676,-4.181234391723241,12.939246667372572,1.143370114301508,0.0563052139661588,1712047296.0,1
504,2012-02-06,2334.25,2341.57,2317.42,2331.14,75734477.0,0.7300000000000182,0.0,0.7300000000000182,63.6459218801145,2196.12,2341.57,92.82915091096578,-7.170849089034219,15.749461690626047,4.064588429566418,0.0142535176950719,1787781773.0,1
505,2012-02-07,2319.42,2319.71,2278.82,2291.9,67326906.0,-39.23999999999978,39.23999999999978,0.0,51.35714888190222,2196.12,2341.57,65.85080783774494,-34.149192162255055,14.641459652541016,6.179962674161338,0.0112602476195518,1720454867.0,0
506,2012-02-08,2291.81,2350.97,2286.82,2347.53,87114528.0,55.63000000000011,0.0,55.63000000000011,63.03282771077535,2196.12,2350.97,97.77849531805,-2.2215046819500173,18.044233444325982,8.552816828194269,0.0224122086870173,1807569395.0,1
507,2012-02-09,2344.22,2363.61,2333.94,2349.59,98032325.0,2.059999999999945,0.0,2.059999999999945,63.40810654213925,2196.12,2363.61,91.62935100603023,-8.370648993969766,20.668922501201905,10.976037962795797,0.0131386042981822,1905601720.0,1
508,2012-02-10,2342.01,2368.98,2339.89,2351.98,96501619.0,2.3899999999998727,0.0,2.3899999999998727,63.89871951705966,2196.12,2368.98,90.16545181071388,-9.83454818928612,22.680414810706225,13.316913332377885,0.0292948919931379,2002103339.0,1
509,2012-02-13,2332.05,2365.34,2325.03,2351.85,86263585.0,-0.1300000000001091,0.1300000000001091,0.0,63.84499477233303,2257.9,2368.98,84.57868203096857,-15.421317969031437,23.987533687831277,15.451037403468565,0.0258395453217075,1915839754.0,0
510,2012-02-14,2348.88,2352.47,2332.25,2344.77,73130413.0,-7.079999999999927,7.079999999999927,0.0,60.6410380277933,2259.34,2368.98,77.91864283108349,-22.08135716891651,24.173481142127912,17.195526151200436,0.0338127402913477,1842709341.0,0
511,2012-02-15,2340.46,2374.28,2335.1,2366.7,98861021.0,21.92999999999984,0.0,21.92999999999984,66.6267004010241,2263.34,2374.28,93.16747791599028,-6.832522084009715,25.793086912392937,18.915038303438937,0.0234112844639706,1941570362.0,1
512,2012-02-16,2363.9,2373.8,2342.07,2356.86,95051169.0,-9.83999999999969,9.83999999999969,0.0,61.76367972469161,2263.34,2374.28,84.29781864070664,-15.702181359293368,25.983113234824486,20.328653289716048,0.0113499341317624,1846519193.0,0
513,2012-02-17,2366.63,2372.51,2344.76,2357.18,71924839.0,0.3199999999997089,0.0,0.3199999999997089,61.86811539699291,2263.34,2374.28,84.58626284478065,-15.413737155219357,25.861417467671345,21.435206125307108,0.011170500270254,1918444032.0,1
514,2012-02-20,2383.69,2388.01,2362.01,2363.6,88911586.0,6.420000000000073,0.0,6.420000000000073,64.1357225499858,2263.34,2388.01,80.42030961738968,-19.579690382610327,25.983491525114005,22.34486320526849,0.0312840874383697,2007355618.0,1
515,2012-02-21,2365.49,2382.15,2345.05,2381.43,79348669.0,17.829999999999927,0.0,17.829999999999927,69.87626117740488,2268.69,2388.01,94.4854173650684,-5.51458263493159,27.20536160971824,23.316962886158443,0.0144407100228749,2086704287.0,1
516,2012-02-22,2380.5,2404.44,2374.03,2403.59,118684269.0,22.16000000000031,0.0,22.16000000000031,75.49997703025224,2278.82,2404.44,99.3233561534788,-0.6766438465211828,29.62038390837188,24.577647090601133,0.0229827331576999,2205388556.0,1
517,2012-02-23,2401.74,2416.8,2396.71,2409.55,112553593.0,5.960000000000036,0.0,5.960000000000036,76.84164955919728,2278.82,2416.8,94.74561530656617,-5.25438469343383,31.65038275878805,25.99219422423852,0.0244772489561986,2317942149.0,1
518,2012-02-24,2410.88,2439.98,2405.27,2439.63,134903249.0,30.079999999999927,0.0,30.079999999999927,82.44121159392085,2278.82,2439.98,99.782824522214,-0.2171754777859948,35.27969373550968,27.84969412649276,0.0373238089163849,2452845398.0,1
519,2012-02-27,2447.41,2478.38,2444.63,2447.06,158073244.0,7.429999999999836,0.0,7.429999999999836,83.5732397917832,2286.82,2478.38,83.65003132177898,-16.349968678221014,38.313829757322765,29.942521252658764,0.043624747843072,2610918642.0,1
520,2012-02-28,2440.91,2458.65,2431.83,2451.86,118361993.0,4.800000000000182,0.0,4.800000000000182,84.32647350890252,2325.03,2478.38,82.70622758395827,-17.293772416041733,40.63728299655213,32.08147360143744,0.0359825917944818,2729280635.0,1
521,2012-02-29,2446.23,2453.07,2426.33,2428.49,95536952.0,-23.370000000000346,23.370000000000346,0.0,67.05357712969409,2325.03,2478.38,67.46657971959547,-32.533420280404535,40.13027589912099,33.691234060974146,0.0303921319043132,2633743683.0,0
522,2012-03-01,2418.79,2437.87,2418.33,2426.11,75083289.0,-2.3799999999996544,2.3799999999996544,0.0,65.47756377732654,2325.03,2478.38,65.91457450277143,-34.08542549722857,39.08586548490439,34.7701603457602,0.0292425695110261,2558660394.0,0
523,2012-03-02,2430.1,2461.12,2430.1,2460.69,103228378.0,34.57999999999993,0.0,34.57999999999993,75.2355881419721,2332.25,2478.38,87.89434065558062,-12.10565934441938,40.58069076738593,35.93226643008534,0.0410771704180064,2661888772.0,1
524,2012-03-05,2464.85,2469.84,2442.11,2445.0,112693326.0,-15.690000000000056,15.690000000000056,0.0,65.53730416553152,2335.1,2478.38,76.70295924064764,-23.29704075935236,40.03776823066983,36.75336679020224,0.0266940451745381,2549195446.0,0
525,2012-03-06,2439.78,2442.0,2406.06,2410.45,103709012.0,-34.55000000000018,34.55000000000018,0.0,49.36803382958178,2342.07,2478.38,50.16506492553714,-49.834935074462855,36.40000535169656,36.68269450250111,0.0028540641290735,2445486434.0,0
526,2012-03-07,2391.2,2413.7,2388.52,2394.79,94790636.0,-15.659999999999854,15.659999999999854,0.0,43.7260284616467,2344.76,2478.38,37.44199970064346,-62.55800029935654,31.885860584960483,35.723327718992984,-0.006125625116723,2350695798.0,0
527,2012-03-08,2401.1,2426.7,2401.1,2420.28,96782134.0,25.49000000000024,0.0,25.49000000000024,53.670303051547066,2345.05,2478.38,56.423910597764994,-43.57608940223501,30.019156159911745,34.582493407176734,-0.0079315306009517,2447477932.0,1
528,2012-03-09,2425.89,2440.51,2414.97,2439.46,100624055.0,19.17999999999984,0.0,19.17999999999984,59.83288681656221,2345.05,2478.38,70.80927023175573,-29.19072976824428,29.744568292310305,33.614908384203446,-0.0031057677376116,2548101987.0,1
529,2012-03-12,2438.55,2440.86,2420.84,2434.86,106223059.0,-4.599999999999909,4.599999999999909,0.0,57.708657100578655,2374.03,2478.38,58.29420220412073,-41.70579779587927,28.82351434142811,32.65662957564838,-0.0069335117013206,2441878928.0,0
530,2012-03-13,2432.84,2457.22,2428.61,2455.79,104649712.0,20.92999999999984,0.0,20.92999999999984,64.35289393446632,2388.52,2478.38,74.86089472512785,-25.139105274872147,29.443047407358332,32.01391314199037,0.0112415533932608,2546528640.0,1
531,2012-03-14,2464.92,2476.22,2382.84,2391.23,179786029.0,-64.55999999999995,64.55999999999995,0.0,41.27408870273064,2382.84,2478.38,8.781662131044458,-91.21833786895554,24.442817787704826,30.499694071133263,-0.0143769243768832,2366742611.0,0
532,2012-03-15,2388.06,2403.74,2366.02,2373.77,120025499.0,-17.460000000000036,17.460000000000036,0.0,37.11994781419498,2366.02,2478.38,6.897472410110352,-93.10252758988965,18.85388782600785,28.17053282210818,-0.0353234255432419,2246717112.0,0
533,2012-03-16,2377.76,2406.15,2368.31,2404.74,103675622.0,30.9699999999998,0.0,30.9699999999998,47.86027142827618,2366.02,2476.22,35.13611615244997,-64.86388384755003,16.730778735493004,25.882582004785142,-0.0164662576687117,2350392734.0,1
534,2012-03-19,2401.22,2412.34,2383.67,2410.18,102153490.0,5.440000000000055,0.0,5.440000000000055,49.60488216085287,2366.02,2476.22,40.07259528130665,-59.92740471869335,15.310670146223856,23.76819963307289,-0.0001120122798647,2452546224.0,1
535,2012-03-20,2407.54,2407.54,2376.03,2376.84,97903935.0,-33.33999999999969,33.33999999999969,0.0,40.11340327304362,2366.02,2476.22,9.818511796733375,-90.18148820326662,11.363967745557147,21.287353255569744,-0.0074954380133539,2354642289.0,0
536,2012-03-21,2384.71,2396.72,2361.22,2378.2,95686538.0,1.3599999999996726,0.0,1.3599999999996726,40.64792649717864,2361.22,2476.22,14.765217391304365,-85.23478260869564,8.250808112607046,18.68004422697721,-0.0173864181003852,2450328827.0,1
537,2012-03-22,2376.99,2386.1,2364.13,2375.77,79348880.0,-2.4299999999998363,2.4299999999998363,0.0,39.91346065585471,2361.22,2476.22,12.652173913043638,-87.34782608695636,5.523850472972754,16.048805476176316,-0.0261082370688595,2370979947.0,0
538,2012-03-23,2369.08,2371.26,2342.12,2349.54,76862139.0,-26.230000000000015,26.230000000000015,0.0,32.58116816537667,2342.12,2476.22,5.53318419090237,-94.46681580909762,1.2319736843933242,13.085439117819716,-0.0350410290530052,2294117808.0,0
539,2012-03-26,2349.09,2358.0,2339.14,2350.6,55427733.0,1.0599999999999454,0.0,1.0599999999999454,33.15377008058009,2339.14,2476.22,8.360081704114416,-91.63991829588558,-2.0600890267091927,10.056333488913936,-0.0428334670309757,2349545541.0,1
540,2012-03-27,2358.54,2363.77,2344.3,2347.18,60881116.0,-3.4200000000000728,3.4200000000000728,0.0,32.13763003396919,2339.14,2476.22,5.865188211263472,-94.13481178873651,-4.888684153337181,7.067329960463712,-0.0184214818315261,2288664425.0,0
541,2012-03-28,2341.0,2341.42,2281.43,2284.88,83645283.0,-62.29999999999973,62.29999999999973,0.0,19.54588656066241,2281.43,2476.22,1.7711381487757447,-98.22886185122424,-12.01890900578519,3.2500821672139306,-0.0374467619019533,2205019142.0,0
542,2012-03-29,2276.74,2280.96,2242.34,2252.16,74248084.0,-32.720000000000255,32.720000000000255,0.0,15.795482415637338,2242.34,2476.22,4.198734393706056,-95.80126560629394,-20.07844233456035,-1.4156227331409268,-0.0634496868684347,2130771058.0,0
543,2012-03-30,2256.04,2266.21,2246.25,2262.79,62024147.0,10.63000000000011,0.0,10.63000000000011,21.445643719527556,2242.34,2476.22,8.743800239438963,-91.25619976056105,-25.31610015813567,-6.195718218139877,-0.0611531088964308,2192795205.0,1
544,2012-04-05,2258.03,2303.82,2251.39,2302.24,80101456.0,39.44999999999982,0.0,39.44999999999982,38.97904286511566,2242.34,2476.22,25.61142466221982,-74.38857533778017,-25.98416711212621,-10.153407996937148,-0.0313862102623653,2272896661.0,1
545,2012-04-06,2299.05,2309.64,2291.56,2306.55,72136521.0,4.3100000000004,0.0,4.3100000000004,40.6489877774772,2242.34,2412.34,37.77058823529414,-62.229411764705866,-25.86764786397453,-13.296255970344625,-0.0301278277689006,2345033182.0,1
546,2012-04-09,2300.05,2304.65,2284.44,2285.78,59760639.0,-20.769999999999985,20.769999999999985,0.0,35.280360250910675,2242.34,2412.34,25.552941176470625,-74.44705882352937,-27.13843594175933,-16.064691964627567,-0.0378782457897859,2285272543.0,0
547,2012-04-10,2281.02,2306.39,2258.85,2305.86,67345526.0,20.079999999999927,0.0,20.079999999999927,43.591043380611374,2242.34,2412.34,37.364705882352936,-62.63529411764706,-26.222974339547815,-18.096348439611617,-0.0185908731070761,2352618069.0,1
548,2012-04-11,2286.72,2319.05,2280.03,2308.93,75130070.0,3.069999999999709,0.0,3.069999999999709,44.84056286370375,2242.34,2407.54,40.308716707021645,-59.69128329297835,-24.961994744202,-19.46947770052969,-0.0177273887518081,2427748139.0,1
549,2012-04-12,2310.48,2351.05,2307.84,2350.86,97687895.0,41.93000000000029,0.0,41.93000000000029,59.11340113138531,2242.34,2396.72,70.29407954398252,-29.70592045601747,-20.34473728637613,-19.644529617698986,0.0015678388534328,2525436034.0,1
550,2012-04-13,2351.51,2369.7,2346.94,2359.16,98774414.0,8.299999999999727,0.0,8.299999999999727,61.39497975895901,2242.34,2386.1,81.2604340567612,-18.7395659432388,-15.833270762023858,-18.88227784656396,0.0325093659185602,2624210448.0,1
551,2012-04-16,2346.31,2364.11,2342.2,2357.03,85322682.0,-2.1299999999996544,2.1299999999996544,0.0,60.39700563680846,2242.34,2371.26,88.9621470679491,-11.037852932050892,-12.288124388106551,-17.563447154872478,0.0465641872691107,2538887766.0,0
552,2012-04-17,2355.37,2363.01,2333.34,2334.99,84688445.0,-22.04000000000042,22.04000000000042,0.0,50.58064176611772,2242.34,2369.7,72.74654522613055,-27.253454773869446,-11.128729087879492,-16.27650354147388,0.0319075124072494,2454199321.0,0
553,2012-04-18,2341.14,2383.64,2337.86,2380.85,108612544.0,45.86000000000013,0.0,45.86000000000013,64.4520411567932,2242.34,2383.64,98.0254777070064,-1.9745222929936088,-6.435200244819953,-14.308242882143093,0.0341450066022657,2562811865.0,1
554,2012-04-19,2378.63,2386.98,2369.46,2378.63,94272421.0,-2.2199999999998,2.2199999999998,0.0,63.45716128113963,2242.34,2386.98,94.22704646017704,-5.772953539822951,-2.861692459006008,-12.018932797515676,0.0312501354837311,2468539444.0,0
555,2012-04-20,2374.66,2407.29,2372.13,2406.86,115522062.0,28.230000000000015,0.0,28.230000000000015,70.20523407243849,2242.34,2407.29,99.7393149439225,-0.2606850560775003,2.2226420450820115,-9.17061782899614,0.0529709770844086,2584061506.0,1
556,2012-04-23,2403.52,2411.51,2383.07,2388.59,122907558.0,-18.269999999999985,18.269999999999985,0.0,61.69738442134566,2246.25,2411.51,86.13094517729635,-13.869054822703644,4.723329852613915,-6.391828292674128,0.0358781539208798,2461153948.0,0
557,2012-04-24,2380.24,2415.75,2350.4,2388.83,133722354.0,0.2399999999997817,0.0,0.2399999999997817,61.7676111358407,2251.39,2415.75,83.62131905573129,-16.378680944268712,6.647876370166159,-3.7838873601060703,0.0346047736397379,2594876302.0,1
558,2012-04-25,2382.21,2411.42,2376.63,2406.81,130972867.0,17.980000000000018,0.0,17.980000000000018,66.99806812209732,2258.85,2415.75,94.30210325047796,-5.69789674952202,9.51425468026946,-1.1242589520309636,0.023799800923917,2725849169.0,1
559,2012-04-26,2408.56,2414.75,2393.26,2404.7,115529587.0,-2.1100000000001278,2.1100000000001278,0.0,65.77952856692539,2258.85,2415.75,92.95729764180996,-7.042702358190042,11.483249029436138,1.3972426442624577,0.0193034808999812,2610319582.0,0
560,2012-04-27,2402.43,2408.42,2393.87,2396.32,91228350.0,-8.379999999999654,8.379999999999654,0.0,60.718832732450615,2258.85,2415.75,87.61631612492044,-12.383683875079557,12.226555154516063,3.5631051463131795,0.0166692829535475,2519091232.0,0
561,2012-05-02,2421.08,2446.35,2407.79,2438.44,128006006.0,42.11999999999989,0.0,42.11999999999989,72.83801340593489,2280.03,2446.35,95.24410774410782,-4.755892255892177,16.02958354135035,6.056400825320615,0.044304258262348,2647097238.0,1
562,2012-05-03,2433.59,2441.95,2427.73,2440.08,102248493.0,1.639999999999873,0.0,1.639999999999873,73.20935655165728,2307.84,2446.35,95.4732510288066,-4.526748971193411,18.95731708042149,8.63658407634079,0.0248776697397987,2749345731.0,1
563,2012-05-04,2437.47,2453.73,2427.97,2452.01,102204871.0,11.930000000000293,0.0,11.930000000000293,75.96716096128262,2333.34,2453.73,98.57130990946108,-1.4286900905389166,21.986768518948335,11.3066209648623,0.030849690788395,2851550602.0,1
564,2012-05-07,2441.76,2451.95,2432.74,2451.95,108830107.0,-0.0600000000004001,0.0600000000004001,0.0,75.92180800800551,2333.34,2453.73,98.5214718830466,-1.478528116953403,24.10492256885982,13.866281285661806,0.0187339521201896,2742720495.0,0
565,2012-05-08,2451.57,2451.6,2431.02,2448.88,104855537.0,-3.069999999999709,3.069999999999709,0.0,73.33694505013766,2333.34,2453.73,95.97142619818928,-4.02857380181071,25.244844715442014,16.141993971617847,0.0252408324576423,2637864958.0,0
566,2012-05-09,2432.47,2432.47,2407.51,2408.59,97902212.0,-40.28999999999997,40.28999999999997,0.0,48.38939236754005,2337.86,2453.73,61.04254768274798,-38.95745231725202,22.63623848025236,17.44084287334475,0.0082718318172494,2539962746.0,0
567,2012-05-10,2409.95,2419.12,2402.2,2410.23,81698471.0,1.639999999999873,0.0,1.639999999999873,49.201015932185605,2350.4,2453.73,57.901867802187134,-42.09813219781286,20.465322045499303,18.045738707775666,0.0014209680032906,2621661217.0,1
568,2012-05-11,2406.07,2415.98,2393.38,2394.98,74863995.0,-15.25,15.25,0.0,42.09788450611369,2350.4,2453.73,43.14332720410332,-56.85667279589668,17.314714331143023,17.899533832449134,-0.0040420842516737,2546797222.0,0
569,2012-05-14,2408.26,2411.27,2377.98,2380.73,90526339.0,-14.25,14.25,0.0,36.42766308362575,2350.4,2453.73,29.352559759992207,-70.6474402400078,13.512218665124236,17.022070798984156,-0.0065058089069908,2456270883.0,0
570,2012-05-15,2367.08,2376.59,2354.61,2374.84,77922916.0,-5.889999999999873,5.889999999999873,0.0,34.228887682356955,2350.4,2453.73,23.65237588309307,-76.34762411690693,9.909212446276342,15.599499128442591,-0.0260822493069339,2378347967.0,0
571,2012-05-16,2369.29,2372.03,2344.5,2346.19,76733829.0,-28.65000000000009,28.65000000000009,0.0,25.567387029756347,2344.5,2453.73,1.5471939943239534,-98.45280600567604,4.6879487426631385,13.417189051286703,-0.0384782466148649,2301614138.0,0
572,2012-05-17,2347.18,2383.31,2342.35,2378.89,86870030.0,32.69999999999982,0.0,32.69999999999982,44.17209058306377,2342.35,2453.73,32.80660800861908,-67.19339199138092,3.152338162992692,11.3642188736279,-0.0298204330324918,2388484168.0,1
573,2012-05-18,2364.9,2369.6,2338.24,2344.52,89689419.0,-34.36999999999989,34.36999999999989,0.0,33.896731664225086,2338.24,2453.73,5.437700233786638,-94.56229976621336,-0.8284660024246477,8.925681898417391,-0.0438141071392156,2298794749.0,0
574,2012-05-21,2343.58,2360.39,2330.32,2348.3,74840341.0,3.7800000000002,0.0,3.7800000000002,35.79211723680251,2330.32,2453.73,14.569321772951982,-85.43067822704802,-3.636349995244928,6.413275519684927,-0.041071836921368,2373635090.0,1
575,2012-05-22,2355.73,2374.06,2354.87,2373.31,76779780.0,25.009999999999764,0.0,25.009999999999764,47.32306345996029,2330.32,2453.73,34.83510250384882,-65.16489749615117,-3.799719505343546,4.370676514679232,-0.014647573891779,2450414870.0,1
576,2012-05-23,2369.26,2378.08,2350.55,2363.44,84216580.0,-9.86999999999989,9.86999999999989,0.0,43.74569795454688,2330.32,2453.73,26.837371363746804,-73.1626286362532,-4.671764340829668,2.562188343577452,-0.0194130850582724,2366198290.0,0
577,2012-05-24,2359.68,2373.06,2344.58,2350.97,79206805.0,-12.470000000000256,12.470000000000256,0.0,39.40338424843913,2330.32,2451.95,16.977719312669322,-83.02228068733068,-6.296508706629084,0.7904489335361443,-0.0183759363334976,2286991485.0,0
578,2012-05-25,2350.54,2355.81,2327.41,2333.55,74019252.0,-17.419999999999618,17.419999999999618,0.0,33.968483603395896,2327.41,2451.6,4.944037362106711,-95.05596263789327,-8.887331116225141,-1.1451070764161135,-0.0198174509499186,2212972233.0,0
579,2012-05-28,2325.32,2361.74,2309.07,2361.37,94962105.0,27.81999999999971,0.0,27.81999999999971,47.35019684128571,2309.07,2432.47,42.38249594813605,-57.61750405186395,-8.59663834749017,-2.635413330630925,-0.0056719610584292,2307934338.0,1
580,2012-05-29,2361.0,2393.28,2358.37,2389.64,117157725.0,28.269999999999985,0.0,28.269999999999985,57.45871774891344,2309.07,2419.12,73.21217628350742,-26.787823716492586,-6.015763519022585,-3.311483368309258,0.0185193867504336,2425092063.0,1
581,2012-05-30,2385.39,2391.69,2378.13,2384.67,89809793.0,-4.9699999999998,4.9699999999998,0.0,55.304785392674624,2309.07,2415.98,70.71368440744553,-29.286315592554477,-4.321622117584411,-3.5135111181642897,0.0024297046101333,2335282270.0,0
582,2012-05-31,2370.01,2382.99,2362.31,2372.23,77890228.0,-12.440000000000056,12.440000000000056,0.0,49.902131741973335,2309.07,2411.27,61.80039138943245,-38.19960861056755,-3.937418773237823,-3.5982926491789966,0.0118190503813147,2257392042.0,0
583,2012-06-01,2373.22,2388.09,2365.44,2373.44,77021923.0,1.2100000000000364,0.0,1.2100000000000364,50.44543335557076,2309.07,2393.28,76.43985274907952,-23.56014725092048,-3.4950096712764207,-3.577636053598482,0.0107056168291954,2334413965.0,1
584,2012-06-04,2346.98,2348.2,2308.23,2308.55,90179347.0,-64.88999999999987,64.88999999999987,0.0,30.18766555116281,2308.23,2393.28,0.3762492651383457,-99.62375073486164,-8.284973939867996,-4.519103630852385,-0.0272867851228872,2244234618.0,0
585,2012-06-05,2313.74,2323.3,2304.05,2311.92,66078528.0,3.369999999999891,0.0,3.369999999999891,31.828160059172504,2304.05,2393.28,8.819903619858668,-91.18009638014132,-11.674547381757748,-5.9501923810334585,-0.0217987340486748,2310313146.0,1
586,2012-06-06,2315.56,2323.11,2301.03,2309.55,58532028.0,-2.369999999999891,2.369999999999891,0.0,31.232611374982824,2301.03,2393.28,9.235772357723558,-90.76422764227644,-14.386212643844829,-7.637396433595733,-0.0176182596970611,2251781118.0,0
587,2012-06-07,2324.67,2328.67,2288.67,2293.13,60232048.0,-16.420000000000073,16.420000000000073,0.0,27.168674933151134,2288.67,2393.28,4.263454736640886,-95.73654526335912,-17.65664881620569,-9.641246910117726,-0.0173212487411883,2191549070.0,0
588,2012-06-08,2306.22,2306.88,2276.71,2281.45,67924641.0,-11.680000000000293,11.680000000000293,0.0,24.54713205464303,2276.71,2393.28,4.066226301792721,-95.93377369820728,-20.949478879265826,-11.902893303947348,-0.0338447596098875,2123624429.0,0
589,2012-06-11,2282.89,2311.77,2278.16,2305.86,64197967.0,24.41000000000031,0.0,24.41000000000031,38.789635069377205,2276.71,2393.28,25.006433902376298,-74.9935660976237,-21.34335452548976,-13.790985548255833,-0.035059674260558,2187822396.0,1
590,2012-06-12,2295.07,2298.95,2280.95,2289.79,59941982.0,-16.070000000000164,16.070000000000164,0.0,33.92523352079971,2276.71,2393.28,11.220725744187964,-88.77927425581204,-22.690654766543048,-15.570919391913275,-0.0397874758352309,2127880414.0,0
591,2012-06-13,2289.71,2319.71,2284.65,2318.92,78454349.0,29.13000000000011,0.0,29.13000000000011,47.65495723218434,2276.71,2393.28,36.21000257356093,-63.78999742643907,-21.163888234415936,-16.68951316041381,-0.0224725258512032,2206334763.0,1
592,2012-06-14,2306.78,2314.58,2293.06,2295.95,71633722.0,-22.97000000000025,22.97000000000025,0.0,40.077915143685125,2276.71,2393.28,16.505104229218283,-83.49489577078172,-21.55888439033424,-17.6633874063979,-0.0326488135364704,2134701041.0,0
593,2012-06-15,2299.78,2314.24,2283.4,2306.85,68687579.0,10.900000000000093,0.0,10.900000000000093,44.8767910198464,2276.71,2393.28,25.85570901604172,-74.14429098395829,-20.753153351349283,-18.281340595388176,-0.0007363929739447,2203388620.0,1
594,2012-06-18,2313.53,2325.05,2309.71,2316.05,60594622.0,9.200000000000273,0.0,9.200000000000273,48.86501866543309,2276.71,2391.69,34.21464602539584,-65.78535397460415,-19.151476288311187,-18.45536773397278,0.0017863939928717,2263983242.0,1
595,2012-06-19,2313.46,2313.46,2298.39,2300.79,60135905.0,-15.260000000000218,15.260000000000218,0.0,42.921604330532496,2276.71,2388.09,21.619680373496053,-78.38031962650395,-18.895672591762377,-18.543428705530697,-0.0037929466779244,2203847337.0,0
596,2012-06-20,2300.41,2304.46,2291.54,2292.88,54103955.0,-7.9099999999998545,7.9099999999998545,0.0,40.01097482424196,2276.71,2388.09,14.517866762434958,-85.48213323756504,-19.110918440999285,-18.656926652624417,-0.0001090212940391,2149743382.0,0
597,2012-06-21,2288.45,2288.45,2253.79,2260.88,58992012.0,-32.0,32.0,0.0,30.39094216260291,2253.79,2348.2,7.509797690922737,-92.49020230907726,-21.614476659734464,-19.24843665404643,-0.0090161958403645,2090751370.0,0
598,2012-06-25,2253.51,2253.51,2223.05,2224.11,59768952.0,-36.76999999999998,36.76999999999998,0.0,23.04476681811809,2223.05,2328.67,1.0035978034462665,-98.99640219655372,-26.26285444752148,-20.65132021274144,-0.0354531498009419,2030982418.0,0
599,2012-06-26,2214.65,2229.24,2203.94,2222.07,52940798.0,-2.039999999999964,2.039999999999964,0.0,22.693606773295244,2203.94,2328.67,14.535396456345792,-85.4646035436542,-29.768189130858445,-22.47469399636484,-0.0295747644980542,1978041620.0,0
600,2012-06-27,2219.94,2233.54,2213.32,2216.93,51049128.0,-5.140000000000327,5.140000000000327,0.0,21.73090568449625,2203.94,2328.67,10.41449530986914,-89.58550469013086,-32.58532383568536,-24.496819964228948,-0.0439816811274215,1926992492.0,0
601,2012-06-28,2220.24,2224.16,2195.36,2195.84,54182183.0,-21.08999999999969,21.08999999999969,0.0,18.09642690046141,2195.36,2325.05,0.3701133472125977,-99.6298866527874,-36.103531096325696,-26.8181621906483,-0.0436028659160694,1872810309.0,0
602,2012-06-29,2190.58,2226.49,2188.72,2225.43,61441886.0,29.58999999999969,0.0,29.58999999999969,35.547444130548186,2188.72,2325.05,26.92730873615487,-73.07269126384513,-36.088069194020136,-28.672143591322676,-0.0352948826321607,1934252195.0,1
603,2012-07-02,2234.32,2234.87,2215.36,2226.11,62196207.0,0.680000000000291,0.0,0.680000000000291,35.9095396443434,2188.72,2325.05,27.426098437614776,-72.57390156238522,-35.61045010595717,-30.059804894249577,-0.0388333585198937,1996448402.0,1
604,2012-07-03,2225.57,2244.83,2219.05,2229.19,62703021.0,3.0799999999999272,0.0,3.0799999999999272,37.737632867223695,2188.72,2325.05,29.685322379520382,-70.31467762047961,-34.58473201581137,-30.96479031856194,-0.0311197458264335,2059151423.0,1
605,2012-07-04,2233.33,2239.27,2219.45,2227.31,55273656.0,-1.8800000000001087,1.8800000000001087,0.0,36.994448535738506,2188.72,2325.05,28.306315557837625,-71.69368444216238,-33.536950241300474,-31.479222303109644,-0.0285972227068141,2003877767.0,0
606,2012-07-05,2218.22,2218.22,2192.65,2201.35,57967934.0,-25.96000000000004,25.96000000000004,0.0,28.158918520925468,2188.72,2325.05,9.264285190347008,-90.735714809653,-34.404734318349256,-32.06432470615757,-0.0263304553978982,1945909833.0,0
607,2012-07-06,2203.73,2227.47,2185.52,2223.58,76557917.0,22.230000000000015,0.0,22.230000000000015,41.875297425175056,2185.52,2325.05,27.2772880384146,-72.72271196158539,-32.91921205030121,-32.2353021749863,-0.0002382975662176,2022467750.0,1
608,2012-07-09,2210.71,2216.7,2168.61,2170.81,75111472.0,-52.76999999999998,52.76999999999998,0.0,27.49613038336264,2168.61,2313.46,1.5188125647220017,-98.481187435278,-35.58976626137155,-32.90619499226335,-0.0230685801977436,1947356278.0,0
609,2012-07-10,2166.95,2178.2,2156.73,2164.44,58993972.0,-6.369999999999891,6.369999999999891,0.0,26.24108933926428,2156.73,2304.46,5.218980572666375,-94.78101942733362,-37.78464758045629,-33.88188550990194,-0.023676886505212,1888362306.0,0
610,2012-07-11,2160.02,2176.49,2156.6,2175.38,58614472.0,10.940000000000056,0.0,10.940000000000056,32.35924591814597,2156.6,2288.45,14.24345847554055,-85.75654152445945,-38.20098311443553,-34.74570503080866,-0.0093176187700378,1946976778.0,1
611,2012-07-12,2172.06,2197.04,2152.68,2185.49,82133762.0,10.109999999999673,0.0,10.109999999999673,37.85577592955437,2152.68,2253.51,32.539918674997345,-67.46008132500265,-37.28533735770179,-35.25363149618729,-0.0179470933707194,2029110540.0,1
612,2012-07-13,2180.17,2198.66,2177.92,2185.9,57546838.0,0.4100000000003092,0.0,0.4100000000003092,38.09117963770907,2152.68,2244.83,36.04991861096063,-63.95008138903937,-36.11034039891911,-35.42497327673365,-0.0180628989582725,2086657378.0,1
613,2012-07-16,2187.89,2188.06,2146.15,2147.96,67487681.0,-37.940000000000055,37.940000000000055,0.0,27.1216138911752,2146.15,2244.83,1.8342115930279168,-98.16578840697208,-37.80479759190803,-35.90093813976853,-0.0364392447480923,2019169697.0,0
614,2012-07-17,2142.43,2165.33,2141.48,2161.19,55184408.0,13.230000000000018,0.0,13.230000000000018,34.68924793342356,2141.48,2244.83,19.07111756168365,-80.92888243831635,-37.646155249185085,-36.24998156165184,-0.0296860338255563,2074354105.0,1
615,2012-07-18,2159.86,2170.3,2138.79,2169.1,66552659.0,7.9099999999998545,0.0,7.9099999999998545,39.05504629069731,2138.79,2244.83,28.583553376084453,-71.41644662391555,-36.46184965019529,-36.29235517936053,-0.0146501010743407,2140906764.0,1
616,2012-07-19,2164.27,2197.79,2159.94,2184.84,79338049.0,15.740000000000236,0.0,15.740000000000236,47.16432779557272,2138.79,2244.83,43.42700867597152,-56.57299132402848,-33.86284270340593,-35.806452684169614,-0.0174223549411308,2220244813.0,1
617,2012-07-20,2180.01,2185.73,2162.06,2168.64,64346672.0,-16.200000000000273,16.200000000000273,0.0,40.72854070636255,2138.79,2244.83,28.14975480950577,-71.85024519049423,-32.73299005046965,-35.19176015742962,-0.0009996268673905,2155898141.0,0
618,2012-07-23,2154.17,2154.17,2135.56,2141.4,55677081.0,-27.23999999999978,27.23999999999978,0.0,32.20296252705833,2135.56,2239.27,5.631086684022894,-94.36891331597712,-33.64774378334914,-34.88295688261353,-0.0106447857182457,2100221060.0,0
619,2012-07-24,2132.32,2158.95,2131.01,2146.59,54411286.0,5.190000000000055,0.0,5.190000000000055,35.18562749709059,2131.01,2227.47,16.151772755546332,-83.84822724445367,-33.56696401528188,-34.6197583091472,-0.0132344693800623,2154632346.0,1
620,2012-07-25,2141.04,2151.45,2132.83,2136.15,48575894.0,-10.440000000000056,10.440000000000056,0.0,31.925650338825815,2131.01,2227.47,5.328633630520314,-94.67136636947968,-33.95396603157951,-34.48659985363366,-0.0225761728491091,2106056452.0,0
621,2012-07-26,2134.99,2147.66,2124.16,2126.0,52884076.0,-10.150000000000093,10.150000000000093,0.0,28.919858690654596,2124.16,2216.7,1.9883293710829328,-98.01167062891707,-34.6799195653557,-34.52526379597807,-0.0274029004071549,2053172376.0,0
622,2012-07-27,2132.01,2139.15,2120.63,2128.76,52076920.0,2.7600000000002183,0.0,2.7600000000002183,30.9593184339296,2120.63,2198.66,10.419069588619935,-89.58093041138007,-34.63330288024736,-34.54687161283193,-0.0089387139425314,2105249296.0,1
623,2012-07-30,2128.16,2137.74,2107.63,2109.91,51992383.0,-18.850000000000364,18.850000000000364,0.0,25.250062720592737,2107.63,2198.66,2.5046687905083505,-97.49533120949164,-35.7058020257582,-34.77865769541719,-0.0237276685529732,2053256913.0,0
624,2012-07-31,2109.32,2116.9,2100.25,2103.63,53456097.0,-6.279999999999745,6.279999999999745,0.0,23.578579801756877,2100.25,2198.66,3.434610303831028,-96.56538969616896,-36.6401440682439,-35.15095496998253,-0.0301830252178322,1999800816.0,0
625,2012-08-01,2101.72,2130.71,2101.71,2123.36,53804602.0,19.730000000000015,0.0,19.730000000000015,38.36827306275416,2100.25,2198.66,23.483385834773053,-76.51661416522695,-35.38072379875848,-35.19690873573772,-0.028139360319291,2053605418.0,1
626,2012-08-02,2120.15,2126.46,2103.5,2111.18,53467539.0,-12.180000000000293,12.180000000000293,0.0,33.719923755717986,2100.25,2197.79,11.205659216731434,-88.79434078326857,-34.96242331641224,-35.150011651872624,-0.0264958683783385,2000137879.0,0
627,2012-08-03,2113.96,2133.27,2108.33,2132.8,53371329.0,21.620000000000346,0.0,21.620000000000346,46.89658213188412,2100.25,2197.79,33.3709247488212,-66.6290752511788,-32.51159047905912,-34.622327417309926,-0.004016064257028,2053509208.0,1
628,2012-08-06,2129.15,2158.68,2127.26,2154.92,71843204.0,22.11999999999989,0.0,22.11999999999989,56.99058007687655,2100.25,2197.79,56.0488004921059,-43.9511995078941,-28.45636144148557,-33.38913422214505,0.0038805733745148,2125352412.0,1
629,2012-08-07,2153.09,2159.68,2148.9,2157.62,75049798.0,2.699999999999818,0.0,2.699999999999818,58.1119714402811,2100.25,2197.79,58.81689563256091,-41.183104367439086,-24.73951405943808,-31.65921018960366,0.0100507923132737,2200402210.0,1
630,2012-08-08,2158.98,2168.73,2153.02,2160.99,72869536.0,3.369999999999891,0.0,3.369999999999891,59.627934552856544,2100.25,2185.73,71.05755732335022,-28.942442676649776,-21.276690451743438,-29.582706242031616,0.0164581373471306,2273271746.0,1
631,2012-08-09,2159.43,2175.54,2148.69,2174.1,72529246.0,13.110000000000127,0.0,13.110000000000127,65.26984436998721,2100.25,2175.54,98.08739540443612,-1.9126045955638933,-17.27537063999671,-27.12123912162464,0.0212987842687759,2345800992.0,1
632,2012-08-10,2172.96,2176.79,2165.28,2168.81,68368559.0,-5.289999999999964,5.289999999999964,0.0,61.28251045789801,2100.25,2176.79,89.57407891298665,-10.425921087013355,-14.365557446862567,-24.570102786672223,0.027915882667981,2277432433.0,0
633,2012-08-13,2164.04,2164.04,2134.55,2136.08,71352322.0,-32.73000000000002,32.73000000000002,0.0,42.67220939950873,2100.25,2176.79,46.81212437940939,-53.18787562059062,-14.533019390169102,-22.5626861073716,0.0154257164995743,2206080111.0,0
634,2012-08-14,2137.05,2144.01,2119.25,2142.52,67571589.0,6.440000000000055,0.0,6.440000000000055,46.369761864218006,2100.25,2176.79,55.22602560752547,-44.77397439247452,-13.984871119082072,-20.847123109713696,0.0090234345565518,2273651700.0,1
635,2012-08-15,2138.28,2139.14,2118.5,2118.95,54609394.0,-23.570000000000164,23.570000000000164,0.0,36.44340813910124,2100.25,2176.79,24.43166971518138,-75.56833028481861,-15.276266392514572,-19.73295176627387,0.0036804062183233,2219042306.0,0
636,2012-08-16,2116.08,2122.68,2109.66,2112.2,45173009.0,-6.75,6.75,0.0,34.035814813277824,2100.25,2176.79,15.61275150248213,-84.38724849751786,-16.652416348708357,-19.11684468276077,-0.0096586646661667,2173869297.0,0
637,2012-08-17,2111.65,2120.71,2100.79,2114.89,44390634.0,2.6900000000000546,0.0,2.6900000000000546,35.98060226643632,2100.25,2176.79,19.127253723543088,-80.87274627645691,-17.326238492749326,-18.758723444758484,-0.0185760956323205,2218259931.0,1
638,2012-08-20,2102.23,2110.78,2089.02,2106.96,46717499.0,-7.929999999999836,7.929999999999836,0.0,32.70118796866605,2089.02,2176.79,20.439785803805467,-79.56021419619454,-18.289304406253905,-18.664839637057568,-0.0234795747165857,2171542432.0,0
639,2012-08-21,2106.38,2124.2,2103.07,2118.27,60756505.0,11.309999999999944,0.0,11.309999999999944,41.47883555976827,2089.02,2176.79,33.325737723595765,-66.67426227640422,-17.933195883715143,-18.518510886389084,-0.0197687171157663,2232298937.0,1
640,2012-08-22,2118.88,2121.15,2097.6,2107.71,58441412.0,-10.559999999999944,10.559999999999944,0.0,36.36854195380196,2089.02,2176.79,21.29429189928228,-78.70570810071771,-18.29221973775202,-18.47325265666167,-0.0305367738374499,2173857525.0,0
641,2012-08-23,2106.96,2118.74,2097.08,2113.07,58472299.0,5.360000000000127,0.0,5.360000000000127,40.6508929819402,2089.02,2176.79,27.401162128290064,-72.59883787170995,-17.937469540911934,-18.366096033511724,-0.0257007298933515,2232329824.0,1
642,2012-08-24,2108.36,2109.82,2089.22,2092.1,60178948.0,-20.97000000000025,20.97000000000025,0.0,31.17870999699809,2089.02,2176.79,3.509171698758036,-96.49082830124196,-19.12793625802078,-18.518464078413537,-0.0205891165124901,2172150876.0,0
643,2012-08-27,2085.37,2085.37,2055.38,2055.71,60314833.0,-36.38999999999987,36.38999999999987,0.0,21.25969494317897,2055.38,2176.79,0.2718062762539557,-99.72819372374605,-22.74556190523708,-19.363883643778248,-0.0405177081194108,2111836043.0,0
644,2012-08-28,2054.97,2083.96,2052.49,2073.15,54422104.0,17.440000000000055,0.0,17.440000000000055,33.03957665218229,2052.49,2176.79,16.621078037007464,-83.37892196299254,-23.929450239606467,-20.27699696294389,-0.0216144788692511,2166258147.0,1
645,2012-08-29,2066.82,2073.95,2051.77,2053.24,52209808.0,-19.91000000000031,19.91000000000031,0.0,27.600413237504185,2051.77,2176.79,1.1758118701006242,-98.82418812989935,-26.17255990055537,-21.45610955046619,-0.0279140232932487,2114048339.0,0
646,2012-08-30,2044.03,2060.19,2032.54,2052.58,61963792.0,-0.6599999999998545,0.6599999999998545,0.0,27.4277071210026,2032.54,2164.04,15.239543726235713,-84.76045627376429,-27.68436878134935,-22.701761396642823,-0.0294625252377191,2052084547.0,0
647,2012-08-31,2046.29,2059.3,2044.65,2047.52,46143904.0,-5.059999999999945,5.059999999999945,0.0,25.989113632352712,2032.54,2144.01,13.43859334350048,-86.56140665649951,-28.956989770218115,-23.95280707135789,-0.0282112617230512,2005940643.0,0
648,2012-09-03,2044.82,2066.78,2041.16,2059.15,60635498.0,11.63000000000011,0.0,11.63000000000011,35.02684900246297,2032.54,2139.14,24.96247654784254,-75.03752345215746,-28.696314023375635,-24.90150846176144,-0.0279095677132753,2066576141.0,1
649,2012-09-04,2060.61,2063.82,2039.27,2043.65,57462184.0,-15.5,15.5,0.0,29.489184203851732,2032.54,2124.2,12.12088151865606,-87.87911848134394,-29.40152460321815,-25.801511690052788,-0.0303931755317382,2009113957.0,0
650,2012-09-05,2038.87,2048.32,2029.05,2037.68,57649803.0,-5.970000000000027,5.970000000000027,0.0,27.553256775791084,2029.05,2124.2,9.069889647924455,-90.93011035207554,-30.09521922157637,-26.660253196357505,-0.0356779472521023,1951464154.0,0
651,2012-09-06,2040.67,2052.95,2036.37,2051.92,56091817.0,14.240000000000007,0.0,14.240000000000007,38.63981062657,2029.05,2124.2,24.035733053074253,-75.96426694692575,-29.1597922790188,-27.160161012889773,-0.0192055829071267,2007555971.0,1
652,2012-09-07,2062.99,2145.0,2062.99,2127.76,139932624.0,75.84000000000015,0.0,75.84000000000015,68.37760326194478,2029.05,2145.0,85.1315222078484,-14.868477792151596,-22.04468806728255,-26.137066423768328,0.0350487179611911,2147488595.0,1
653,2012-09-10,2128.06,2140.17,2120.49,2134.89,103580026.0,7.129999999999654,0.0,7.129999999999654,69.95704564469392,2029.05,2145.0,91.28072445019394,-8.719275549806058,-15.650179775269407,-24.039689094068542,0.0297807683959192,2251068621.0,1
654,2012-09-11,2127.52,2127.52,2107.22,2120.55,80426638.0,-14.33999999999969,14.33999999999969,0.0,62.69064603031804,2029.05,2145.0,78.91332470892642,-21.08667529107357,-11.60581937810457,-21.55291515087575,0.0327823342619471,2170641983.0,0
655,2012-09-12,2129.69,2137.89,2109.14,2126.55,84114742.0,6.0,0.0,6.0,64.47222795192575,2029.05,2145.0,84.0879689521347,-15.912031047865296,-7.826268418752079,-18.80758580445102,0.0360375722261741,2254756725.0,1
656,2012-09-13,2123.84,2130.08,2110.0,2110.38,79044972.0,-16.170000000000073,16.170000000000073,0.0,56.13655776286552,2029.05,2145.0,70.14230271668833,-29.85769728331167,-6.065808055513116,-16.25923025466344,0.0307005548175354,2175711753.0,0
657,2012-09-14,2127.39,2136.23,2111.12,2123.85,91248271.0,13.4699999999998,0.0,13.4699999999998,60.98502693516844,2029.05,2145.0,81.75937904269074,-18.240620957309257,-3.542874060889517,-13.715959015908654,0.0314207318553771,2266960024.0,1
658,2012-09-17,2120.62,2121.58,2077.48,2078.5,76392233.0,-45.34999999999991,45.34999999999991,0.0,42.66484734658566,2029.05,2145.0,42.647692971108256,-57.35230702889174,-5.143505557285607,-12.001468324184044,0.0170528221564356,2190567791.0,0
659,2012-09-18,2069.34,2074.76,2053.66,2059.54,53794850.0,-18.96000000000004,18.96000000000004,0.0,37.26461882481998,2029.05,2145.0,26.295817162570074,-73.70418283742993,-7.851424757512632,-11.171459610849762,0.0107278866161517,2136772941.0,0
660,2012-09-19,2061.06,2069.95,2055.2,2067.83,52243629.0,8.289999999999964,0.0,8.289999999999964,41.030230050853525,2029.05,2145.0,33.44545062526947,-66.55454937473053,-9.22222840717768,-10.781613370115346,0.0077537135950718,2189016570.0,1
661,2012-09-20,2060.31,2060.31,2023.08,2024.84,67482659.0,-42.99000000000001,42.99000000000001,0.0,30.18800948422077,2023.08,2145.0,1.443569553805766,-98.55643044619424,-13.620524959967495,-11.349395688085778,-0.0483701169304809,2121533911.0,0
662,2012-09-21,2020.55,2041.95,2018.26,2026.69,60289456.0,1.8500000000001364,0.0,1.8500000000001364,31.09214844794816,2018.26,2145.0,6.65141234022413,-93.34858765977587,-16.76368579238124,-12.432253708944872,-0.0506817681473049,2181823367.0,1
663,2012-09-24,2015.77,2040.85,2005.26,2033.19,57637779.0,6.5,0.0,6.5,34.52962337215989,2005.26,2145.0,19.987118935165352,-80.01288106483464,-18.516718515299544,-13.64914667021581,-0.0411968593053689,2239461146.0,1
664,2012-09-25,2028.63,2039.1,2021.81,2029.29,48219408.0,-3.900000000000091,3.900000000000091,0.0,33.37692338515211,2005.26,2145.0,17.196221554315137,-82.80377844568486,-19.990271577240943,-14.91737165162084,-0.0457360513507795,2191241738.0,0
665,2012-09-26,2027.85,2033.04,1999.48,2004.17,50400828.0,-25.11999999999989,25.11999999999989,0.0,26.742179274717174,1999.48,2145.0,3.2229246838922867,-96.77707531610773,-22.920829998109184,-16.518063320918507,-0.0503274291833698,2140840910.0,0
666,2012-09-27,2003.1,2068.07,2002.32,2056.32,76691457.0,52.15000000000009,0.0,52.15000000000009,50.372988103449934,1999.48,2140.17,40.40088137038889,-59.59911862961111,-20.795531552942062,-17.37355696732322,-0.0317960307931349,2217532367.0,1
667,2012-09-28,2042.89,2089.63,2040.35,2086.17,79448952.0,29.84999999999991,0.0,29.84999999999991,59.08874855849234,1999.48,2137.89,62.63275774871768,-37.36724225128232,-16.512228992735345,-17.201291372405645,0.0036901611739235,2296981319.0,1
668,2012-10-08,2084.85,2096.26,2063.09,2074.42,55131612.0,-11.75,11.75,0.0,54.72356064257429,1999.48,2137.89,54.14348674228751,-45.85651325771249,-13.905513551060722,-16.54213580813666,0.0072249143012517,2241849707.0,0
669,2012-10-09,2081.59,2119.34,2081.59,2115.23,84563788.0,40.809999999999945,0.0,40.809999999999945,65.06600220232117,1999.48,2136.23,84.64351005484461,-15.356489945155394,-8.449249161702483,-14.923558478849824,0.0229225806763613,2326413495.0,1
670,2012-10-10,2111.59,2121.99,2102.53,2119.94,78912035.0,4.710000000000036,0.0,4.710000000000036,66.09730743312227,1999.48,2136.23,88.0877513711152,-11.9122486288848,-3.702383908937918,-12.679323564867444,0.0469666739100373,2405325530.0,1
671,2012-10-11,2114.23,2117.84,2101.14,2102.87,74497029.0,-17.070000000000164,17.070000000000164,0.0,58.83409822119899,1999.48,2121.99,84.3931107664681,-15.606889233531898,-1.3028469284645323,-10.404028237586862,0.0375883830284848,2330828501.0,0
672,2012-10-12,2109.07,2127.31,2092.51,2104.93,68262972.0,2.059999999999945,0.0,2.059999999999945,59.4544943970027,1999.48,2127.31,82.49237268246881,-17.507627317531192,0.7563099300655267,-8.171960604056384,0.0352844544779384,2399091473.0,1
673,2012-10-15,2105.02,2107.2,2085.11,2098.7,53940751.0,-6.230000000000018,6.230000000000018,0.0,56.48402002398013,1999.48,2127.31,77.61871235234284,-22.38128764765716,1.864010489539396,-6.164766385337227,0.0342040812303809,2345150722.0,0
674,2012-10-16,2097.05,2111.78,2089.7,2098.81,57818438.0,0.1100000000001273,0.0,0.1100000000001273,56.52826873268788,1999.48,2127.31,77.70476413987326,-22.295235860126745,2.719399697223708,-4.3879331688250405,0.0472215430826725,2402969160.0,1
675,2012-10-17,2104.28,2113.16,2088.04,2105.62,59874065.0,6.809999999999945,0.0,6.809999999999945,59.47207063853202,1999.48,2127.31,83.03215207697718,-16.967847923022816,3.901833980199172,-2.7299797390201976,0.0239748677248676,2462843225.0,1
676,2012-10-18,2108.5,2137.69,2107.49,2131.69,87191092.0,26.070000000000164,0.0,26.070000000000164,68.8035193723717,1999.48,2137.69,95.65878011721294,-4.341219882787062,6.863435381616455,-0.8112967148928667,0.0218198900377246,2550034317.0,1
677,2012-10-19,2129.82,2136.87,2125.74,2128.3,67641279.0,-3.3899999999998727,3.3899999999998727,0.0,66.50598527930042,1999.48,2137.69,93.20599088343832,-6.79400911656166,8.835135221682776,1.1179896724222624,0.0259735251299157,2482393038.0,0
678,2012-10-22,2118.52,2138.03,2112.75,2132.76,60117222.0,4.460000000000036,0.0,4.460000000000036,68.12192963990161,1999.48,2138.03,96.19631901840494,-3.803680981595074,10.635012472769631,3.021394232491737,0.0082875148329024,2542510260.0,1
679,2012-10-23,2132.11,2136.22,2111.92,2114.45,72683806.0,-18.3100000000004,18.3100000000004,0.0,55.44953955678641,2002.32,2138.03,82.62471446466706,-17.375285535332942,10.46334920826166,4.509785227645723,-0.0025896959347907,2469826454.0,0
680,2012-10-24,2106.83,2124.0,2104.67,2115.99,72886618.0,1.5399999999999636,0.0,1.5399999999999636,56.23955146847956,2040.35,2138.03,77.43652743652709,-22.563472563472924,10.332463753638876,5.674320932844354,0.0062390922881585,2542713072.0,1
681,2012-10-25,2114.76,2128.74,2100.61,2101.58,85393109.0,-14.409999999999854,14.409999999999854,0.0,47.20231042535193,2063.09,2138.03,51.36108887109655,-48.63891112890345,8.962653625331768,6.331987471341837,-0.0015915018551685,2457319963.0,0
682,2012-10-26,2100.1,2102.16,2058.06,2066.21,78606435.0,-35.36999999999989,35.36999999999989,0.0,32.43907687275323,2058.06,2138.03,10.191321745654705,-89.8086782543453,4.965763597452224,6.058742696563916,-0.0154810120550815,2378713528.0,0
683,2012-10-29,2061.85,2068.24,2053.09,2058.94,53635009.0,-7.269999999999982,7.269999999999982,0.0,30.199023378715864,2053.09,2138.03,6.887214504355904,-93.11278549564408,1.197764132903103,5.086546983831753,-0.0189964789571233,2325078519.0,0
684,2012-10-30,2059.2,2075.91,2054.26,2062.35,60569092.0,3.4099999999998545,0.0,3.4099999999998545,32.713712732218866,2053.09,2138.03,10.901813044501717,-89.09818695549828,-1.4959991414061733,3.770037758784168,-0.0205497668145249,2385647611.0,1
685,2012-10-31,2061.12,2070.48,2053.58,2068.88,59527234.0,6.5300000000002,0.0,6.5300000000002,37.6749731865622,2053.09,2138.03,18.58959265363781,-81.41040734636219,-3.0685373290689317,2.402322741213548,-0.0294648846689715,2445174845.0,1
686,2012-11-01,2070.02,2109.5,2069.95,2104.43,82886670.0,35.54999999999973,0.0,35.54999999999973,57.40409151306172,2053.09,2138.03,60.44266541087786,-39.557334589122135,-1.429716395424748,1.6359149138858884,-0.0112155241272378,2528061515.0,1
687,2012-11-02,2105.45,2119.22,2096.53,2117.05,76557220.0,12.620000000000346,0.0,12.620000000000346,62.29322853483803,2053.09,2138.03,75.30021191429243,-24.699788085707564,0.877276830597566,1.4841872972282242,-0.0073660421238207,2604618735.0,1
688,2012-11-05,2113.33,2123.33,2104.58,2114.03,71538762.0,-3.019999999999982,3.019999999999982,0.0,60.37963240904244,2053.09,2138.03,71.74476100777021,-28.255238992229792,2.433841018158091,1.6741180414141978,-0.0001986332143109,2533079973.0,0
689,2012-11-06,2113.66,2114.79,2078.47,2106.0,71343850.0,-8.0300000000002,8.0300000000002,0.0,55.17917925636953,2053.09,2138.03,62.29102896161975,-37.70897103838025,2.9850654839888198,1.9363075299291224,-0.0047211943345667,2461736123.0,0
690,2012-11-07,2102.42,2112.63,2093.29,2105.73,59380128.0,-0.2699999999999818,0.2699999999999818,0.0,54.995409816302775,2053.09,2138.03,61.97315752295719,-38.02684247704281,3.3613802024142387,2.221322064426146,0.001974704745953,2402355995.0,0
691,2012-11-08,2091.25,2092.56,2070.65,2071.51,66594561.0,-34.2199999999998,34.2199999999998,0.0,36.983208581333365,2053.09,2138.03,21.68589592653645,-78.31410407346355,0.8881067743727726,1.9546790064154715,0.0025650829296151,2335761434.0,0
692,2012-11-09,2066.5,2077.23,2062.42,2069.07,54223460.0,-2.4400000000000546,2.4400000000000546,0.0,36.012799268246766,2053.09,2136.22,19.22290388548068,-80.77709611451934,-1.2544078119772166,1.3128616427369335,0.0049200073824395,2281537974.0,0
693,2012-11-12,2069.21,2079.57,2061.84,2079.27,56694855.0,10.199999999999818,0.0,10.199999999999818,43.20142776207035,2053.09,2128.74,34.60674157303366,-65.39325842696634,-2.1050456467305594,0.629280184843435,0.0082042330351299,2338232829.0,1
694,2012-11-13,2078.13,2078.13,2044.04,2047.89,61087293.0,-31.37999999999988,31.37999999999988,0.0,30.88466659252279,2044.04,2128.74,4.545454545454716,-95.45454545454528,-5.25075852983673,-0.5467275580925984,-0.0101455860175554,2277145536.0,0
695,2012-11-14,2047.26,2056.49,2040.17,2055.42,48093000.0,7.529999999999973,0.0,7.529999999999973,35.941354121945935,2040.17,2123.33,18.33814333814337,-81.66185666185662,-7.054826930790568,-1.848347432632193,-0.0232889666085351,2325238536.0,1
696,2012-11-15,2045.46,2053.56,2029.87,2030.29,50556857.0,-25.13000000000011,25.13000000000011,0.0,28.0412261038136,2029.87,2123.33,0.4493901134175825,-99.55060988658242,-10.392546311244132,-3.557187208354581,-0.0409815545216222,2274681679.0,0
697,2012-11-16,2026.56,2028.69,2001.72,2014.72,49581680.0,-15.569999999999936,15.569999999999936,0.0,24.233241116044116,2001.72,2123.33,10.689910369213068,-89.31008963078693,-14.131186323721977,-5.671987031428061,-0.0469766275786058,2225099999.0,0
698,2012-11-19,2013.25,2018.38,1995.72,2016.98,45327018.0,2.259999999999991,0.0,2.259999999999991,25.918155161497808,1995.72,2123.33,16.660136352950403,-83.3398636470496,-16.71899617596273,-7.881388860334996,-0.0422697056030388,2270427017.0,1
699,2012-11-20,2020.43,2023.61,2004.17,2008.92,42580635.0,-8.059999999999945,8.059999999999945,0.0,23.74520633748189,1995.72,2123.33,10.344016926573197,-89.65598307342681,-19.198915619445412,-10.144894212157082,-0.0459745551423971,2227846382.0,0
700,2012-11-21,2008.21,2031.15,1995.17,2030.32,53282021.0,21.399999999999864,0.0,21.399999999999864,39.328429437753485,1995.17,2123.33,27.426654182272088,-72.57334581772793,-19.215958880071867,-11.95910714574004,-0.0198840459375047,2281128403.0,1
701,2012-11-22,2021.21,2023.08,2009.72,2015.61,45577847.0,-14.710000000000036,14.710000000000036,0.0,33.8430525475946,1995.17,2123.33,15.948813982521733,-84.05118601747827,-20.183773869109014,-13.604040490413835,-0.0258376951963926,2235550556.0,0
702,2012-11-23,2020.02,2034.88,2017.0,2027.38,51551469.0,11.77000000000021,0.0,11.77000000000021,41.390184146664,1995.17,2114.79,26.92693529510121,-73.0730647048988,-19.77310157996044,-14.837852708323156,-0.0249558739365257,2287102025.0,1
703,2012-11-26,2023.34,2027.27,2014.03,2017.46,44779551.0,-9.920000000000073,9.920000000000073,0.0,37.25689113768213,1995.17,2112.63,18.976672909926748,-81.02332709007325,-20.01735432686678,-15.873753032031882,-0.0148591965388766,2242322474.0,0
704,2012-11-27,2012.07,2014.21,1990.34,1991.17,56627422.0,-26.289999999999964,26.289999999999964,0.0,28.54126068192886,1990.34,2092.56,0.8119741733517457,-99.18802582664826,-22.07781041829685,-17.11456450928488,-0.0312588181490887,2185695052.0,0
705,2012-11-28,1984.48,1984.86,1968.21,1973.52,50505587.0,-17.65000000000009,17.65000000000009,0.0,24.162629034985542,1968.21,2079.57,4.768318965517187,-95.23168103448282,-24.84850609769865,-18.661352826967637,-0.027961522738131,2135189465.0,0
706,2012-11-29,1972.93,1980.56,1961.82,1963.49,49540088.0,-10.029999999999973,10.029999999999973,0.0,21.95418356357561,1961.82,2079.57,1.4182590233546235,-98.58174097664538,-27.53621916734187,-20.43632609504248,-0.0254278510165184,2085649377.0,0
707,2012-11-30,1961.81,1983.42,1959.33,1980.12,56893416.0,16.62999999999988,0.0,16.62999999999988,33.56991415980235,1959.33,2078.13,17.499999999999943,-82.50000000000006,-28.00156451629482,-21.94937377929295,-0.0182748465527671,2142542793.0,1
708,2012-12-03,1977.25,1988.19,1957.88,1959.77,61653375.0,-20.34999999999991,20.34999999999991,0.0,27.740429600564724,1957.88,2056.49,1.916641314268207,-98.0833586857318,-29.670407003180344,-23.493580424070437,-0.0244658821655416,2080889418.0,0
709,2012-12-04,1956.62,1980.12,1949.46,1975.14,62378123.0,15.370000000000118,0.0,15.370000000000118,37.23840913959748,1949.46,2053.56,24.668587896253687,-75.33141210374632,-29.413683515661432,-24.67760104238864,-0.0271779817959729,2143267541.0,1
710,2012-12-05,1973.11,2040.6,1970.2,2031.91,119973040.0,56.76999999999998,0.0,56.76999999999998,59.77289211256116,1949.46,2040.6,90.46521834540286,-9.534781654597149,-24.34868723893669,-24.61181828169825,0.0080868818868731,2263240581.0,1
711,2012-12-06,2029.56,2036.61,2018.38,2029.24,81459219.0,-2.6700000000000728,2.6700000000000728,0.0,58.63049398674587,1949.46,2040.6,87.53565942506044,-12.46434057493956,-20.31589884846653,-23.75263439505191,0.0009174402430722,2181781362.0,0
712,2012-12-07,2028.77,2065.75,2023.96,2061.79,115157289.0,32.549999999999955,0.0,32.549999999999955,67.39591637807733,1949.46,2065.75,96.59472009631092,-3.405279903689085,-14.328205393272356,-21.867748594696,0.0219731741893272,2296938651.0,1
713,2012-12-10,2067.32,2087.01,2064.61,2083.77,115383226.0,21.980000000000015,0.0,21.980000000000015,72.01579065241401,1949.46,2087.01,97.64449291166832,-2.355507088331685,-7.720317866914684,-19.038262449139737,0.0465053209921804,2412321877.0,1
714,2012-12-11,2077.56,2088.64,2070.19,2074.7,93370830.0,-9.070000000000164,9.070000000000164,0.0,67.46424082185305,1949.46,2088.64,89.98419313119696,-10.01580686880304,-3.178749943222556,-15.8663599479563,0.0512687988974014,2318951047.0,0
715,2012-12-12,2073.27,2085.93,2066.39,2082.73,78559142.0,8.0300000000002,0.0,8.0300000000002,69.43746789860576,1949.46,2088.64,95.75370024428808,-4.246299755711928,1.0562534151488308,-12.481837275335277,0.0607286006040264,2397510189.0,1
716,2012-12-13,2077.42,2081.36,2059.47,2061.48,72272324.0,-21.25,21.25,0.0,58.58783872849674,1949.46,2088.64,80.48570196867374,-19.51429803132626,2.667082218258429,-9.452053376616536,0.0410884188837041,2325237865.0,0
717,2012-12-14,2062.69,2152.5,2062.54,2150.62,160873812.0,89.13999999999987,0.0,89.13999999999987,76.42052461134963,1949.46,2152.5,99.07407407407402,-0.9259259259259798,11.009616668349736,-5.35971936762328,0.0973838766794061,2486111677.0,1
718,2012-12-17,2152.1,2169.57,2151.94,2160.34,144242218.0,9.720000000000256,0.0,9.720000000000256,77.6323783658137,1949.46,2169.57,95.80664213347872,-4.19335786652129,18.19570928117537,-0.6486336378635488,0.093765505230009,2630353895.0,1
719,2012-12-18,2155.86,2183.71,2144.73,2162.46,126099467.0,2.119999999999891,0.0,2.119999999999891,77.91798758812561,1949.46,2183.71,90.92849519743864,-9.071504802561366,23.78759711992825,4.238612513694813,0.0642498929578574,2756453362.0,1
720,2012-12-19,2158.67,2175.4,2154.29,2162.24,94391522.0,-0.2200000000002546,0.2200000000002546,0.0,77.79903842937185,1949.46,2183.71,90.83457844183552,-9.165421558164462,27.880072240091977,8.966904458974247,0.0655417791882673,2662061840.0,0
721,2012-12-20,2156.19,2174.82,2142.95,2168.35,99384183.0,6.110000000000127,0.0,6.110000000000127,78.83446506560361,1949.46,2183.71,93.44290288153675,-6.5570971184632345,31.256113177654697,13.424746202710336,0.0516832461113885,2761446023.0,1
722,2012-12-21,2169.57,2190.4,2148.17,2153.31,103372872.0,-15.039999999999964,15.039999999999964,0.0,69.61314051553077,1949.46,2190.4,84.60612600647458,-15.393873993525418,32.34519239451856,17.208835441071983,0.0333722051857929,2658073151.0,0
723,2012-12-24,2150.65,2170.39,2149.82,2159.05,78469664.0,5.7400000000002365,0.0,5.7400000000002365,71.10168450526051,1970.2,2190.4,85.76294277929159,-14.2370572207084,33.287745143975826,20.42461738165275,0.0406564804550058,2736542815.0,1
724,2012-12-25,2154.32,2220.26,2146.86,2213.61,143327708.0,54.559999999999945,0.0,54.559999999999945,81.20143931556213,2018.38,2220.26,96.7059639389736,-3.2940360610263952,37.99922954718022,23.93953981475825,0.0628405986373654,2879870523.0,1
725,2012-12-26,2211.59,2220.48,2206.79,2219.13,121858630.0,5.519999999999982,0.0,5.519999999999982,81.93833939372935,2023.96,2220.48,99.31304701811526,-0.6869529818847493,41.69786570869701,27.49120499354601,0.0764741835962512,3001729153.0,1
726,2012-12-27,2223.66,2234.72,2204.79,2205.9,129023501.0,-13.230000000000018,13.230000000000018,0.0,73.9244927006608,2059.47,2234.72,83.55492154065637,-16.44507845934363,43.06508360494309,30.60598071582542,0.0257042155285454,2872705652.0,0
727,2012-12-28,2207.91,2234.87,2204.0,2233.25,115924934.0,27.34999999999991,0.0,27.34999999999991,78.8569828560031,2059.47,2234.87,99.07639680729768,-0.9236031927023318,45.827261915620966,33.650236955784536,0.0337493172371015,2988630586.0,1
728,2012-12-31,2236.46,2269.51,2236.46,2269.13,128031402.0,35.88000000000011,0.0,35.88000000000011,83.5633834888495,2059.47,2269.51,99.81908207960385,-0.1809179203961666,50.33133595486288,36.98645675560021,0.0493280800569722,3116661988.0,1
729,2013-01-04,2289.51,2296.11,2256.56,2276.99,139469931.0,7.859999999999673,0.0,7.859999999999673,84.43893035269997,2059.47,2296.11,91.92021636240688,-8.079783637593103,53.91360096048175,40.37188559657652,0.0530699644812786,3256131919.0,1
730,2013-01-07,2271.66,2293.32,2266.86,2285.36,118162813.0,8.370000000000346,0.0,8.370000000000346,85.39485501322378,2062.54,2296.11,95.39752536712764,-4.60247463287237,56.77351113912346,43.65221070508591,0.0539626905250536,3374294732.0,1
731,2013-01-08,2284.65,2289.14,2262.98,2276.07,122907877.0,-9.289999999999964,9.289999999999964,0.0,79.16662673656896,2142.95,2296.11,86.91564377121969,-13.084356228780312,57.626107305989535,46.44699002526664,0.0570099056800925,3251386855.0,0
732,2013-01-09,2271.3,2283.9,2259.05,2275.34,122014924.0,-0.7300000000000182,0.7300000000000182,0.0,78.64654986018533,2142.95,2296.11,86.4390180203709,-13.560981979629108,57.57915436201256,48.67342289261583,0.0538616521155137,3129371931.0,0
733,2013-01-10,2274.38,2295.48,2268.65,2283.66,120066676.0,8.319999999999709,0.0,8.319999999999709,80.34461854887019,2142.95,2296.11,91.87124575607191,-8.12875424392808,57.54989887186503,50.44871808846568,0.0316451407429492,3249438607.0,1
734,2013-01-11,2285.19,2290.21,2234.95,2243.0,125068275.0,-40.659999999999854,40.659999999999854,0.0,55.47075567804112,2142.95,2296.11,65.32384434578218,-34.67615565421783,53.62760583688532,51.08449563814961,0.0107564676246996,3124370332.0,0
735,2013-01-14,2236.29,2317.62,2235.11,2311.74,144749889.0,68.73999999999978,0.0,68.73999999999978,72.23717102498057,2146.86,2317.62,96.55657062543914,-3.443429374560856,55.426976184557134,51.95299174743113,0.0479804161566705,3269120221.0,1
736,2013-01-15,2312.47,2332.78,2309.32,2325.68,165645981.0,13.940000000000056,0.0,13.940000000000056,74.48513488527429,2146.86,2332.78,96.18115318416504,-3.818846815834962,57.31711561723978,53.02581652139286,0.0413881114966976,3434766202.0,1
737,2013-01-16,2322.16,2326.76,2279.51,2309.5,153511167.0,-16.179999999999836,16.179999999999836,0.0,67.19816959341007,2146.86,2332.78,87.47848537005153,-12.521514629948468,56.85409533666643,53.79147228444758,0.0177909595307452,3281255035.0,0
738,2013-01-17,2305.14,2305.6,2275.88,2284.91,119101835.0,-24.590000000000146,24.590000000000146,0.0,57.35806910591752,2204.0,2332.78,62.828078894238025,-37.171921105761975,53.88182479961733,53.80954278748154,0.003478276145262,3162153200.0,0
739,2013-01-18,2295.81,2324.51,2285.97,2317.07,125438026.0,32.16000000000031,0.0,32.16000000000031,65.07557213004033,2204.0,2332.78,87.80090076098772,-12.19909923901228,53.50455500791668,53.74854523156857,0.0138752756677285,3287591226.0,1
740,2013-01-21,2321.49,2329.58,2305.1,2328.22,134680458.0,11.149999999999636,0.0,11.149999999999636,67.43343545600915,2204.0,2332.78,96.45907749650536,-3.5409225034946368,53.48869343313208,53.69657487188128,0.0229123005882945,3422271684.0,1
741,2013-01-22,2326.49,2335.81,2301.3,2315.14,149466584.0,-13.079999999999927,13.079999999999927,0.0,61.78708515727136,2234.95,2335.81,79.50624628197497,-20.493753718025037,51.823289710059726,53.32191783951698,0.0174918913217363,3272805100.0,0
742,2013-01-23,2308.52,2325.12,2296.49,2320.91,118179722.0,5.769999999999982,0.0,5.769999999999982,63.34912758249761,2234.95,2335.81,85.22704739242506,-14.772952607574927,50.38819232349306,52.73517273631221,0.0163115349920741,3390984822.0,1
743,2013-01-24,2320.26,2362.94,2287.3,2302.6,161031674.0,-18.309999999999945,18.309999999999945,0.0,55.10187205620226,2234.95,2362.94,52.85569185092582,-47.14430814907417,47.22897707961874,51.63393360497352,0.0265715559518502,3229953148.0,0
744,2013-01-25,2300.0,2308.38,2288.26,2291.3,92605741.0,-11.299999999999727,11.299999999999727,0.0,50.42699782612353,2234.95,2362.94,44.02687709977362,-55.97312290022638,43.31416197880981,49.969979279740784,-0.0088418247726819,3137347407.0,0
745,2013-01-28,2295.35,2346.92,2295.35,2346.5,128383760.0,55.19999999999982,0.0,55.19999999999982,66.46400477737387,2234.95,2362.94,87.15524650363308,-12.844753496366923,44.15680927044059,48.80734527788075,0.008952220425854,3265731167.0,1
746,2013-01-29,2347.22,2363.8,2337.35,2358.98,141853934.0,12.480000000000018,0.0,12.480000000000018,69.07391991952237,2234.95,2363.8,96.2592161428016,-3.740783857198409,45.30934707134247,48.1077456365731,0.0214245507685646,3407585101.0,1
747,2013-01-30,2360.75,2383.76,2347.89,2382.48,149878907.0,23.5,0.0,23.5,73.54686459542597,2234.95,2383.76,99.13984275250306,-0.8601572474969402,47.57063056696279,48.00032262265104,0.0427019007313198,3557464008.0,1
748,2013-01-31,2383.43,2391.82,2371.23,2385.42,139707892.0,2.9400000000000546,0.0,2.9400000000000546,74.08786699277331,2235.11,2391.82,95.91602322761784,-4.083976772382164,49.03470589182825,48.20719927648649,0.029498461418947,3697171900.0,1
749,2013-02-01,2377.41,2421.15,2369.57,2419.02,140818172.0,33.59999999999991,0.0,33.59999999999991,79.5917346319995,2275.88,2421.15,98.5337647139808,-1.466235286019212,52.303315267243306,49.02642247463786,0.0389997508826487,3837990072.0,1
750,2013-02-04,2425.92,2440.38,2417.58,2428.15,167551402.0,9.13000000000011,0.0,9.13000000000011,80.86597280322297,2275.88,2440.38,92.56534954407294,-7.434650455927063,54.99646147000658,50.220430273711614,0.048813462684762,4005541474.0,1
751,2013-02-05,2411.0,2437.42,2403.3,2433.13,150754505.0,4.980000000000018,0.0,4.980000000000018,81.58943862869062,2275.88,2440.38,95.59270516717324,-4.407294832826747,56.87700095684431,51.55174441033816,0.0483517241082163,4156295979.0,1
752,2013-02-06,2432.68,2441.73,2427.7,2434.48,116579966.0,1.349999999999909,0.0,1.349999999999909,81.80463000236782,2285.97,2441.73,95.34540318438624,-4.654596815613759,57.80987946126834,52.8033714205242,0.0572743854772865,4272875945.0,1
753,2013-02-07,2430.69,2433.89,2394.22,2418.53,120008634.0,-15.949999999999818,15.949999999999818,0.0,70.56120469046866,2287.3,2441.73,84.97701223855478,-15.022987761445211,56.60960046090304,53.56461722859998,0.0555274298433203,4152867311.0,0
754,2013-02-08,2416.62,2443.03,2414.4,2432.4,109070386.0,13.86999999999989,0.0,13.86999999999989,74.12898354520361,2287.3,2443.03,93.17408334938668,-6.82591665061331,56.13052602516473,54.07779898791293,0.0366077136160238,4261937697.0,1
755,2013-02-18,2441.91,2444.8,2415.43,2421.56,116174994.0,-10.840000000000146,10.840000000000146,0.0,66.82563972898895,2287.3,2444.8,85.24444444444428,-14.755555555555706,54.25078934730482,54.112397059791306,0.0265284148233557,4145762703.0,0
756,2013-02-19,2420.26,2427.07,2373.53,2382.91,123473334.0,-38.65000000000009,38.65000000000009,0.0,47.55178289289044,2287.3,2444.8,60.704761904761696,-39.295238095238304,49.07662768405498,53.10524318464404,0.0001804842013364,4022289369.0,0
757,2013-02-20,2383.49,2397.94,2370.61,2397.18,110280577.0,14.269999999999982,0.0,14.269999999999982,53.29095058283858,2288.26,2444.8,69.57966015075996,-30.42033984924004,45.60186709109257,51.60456796593376,0.0049299494428654,4132569946.0,1
758,2013-02-21,2378.82,2378.82,2309.17,2325.95,144059478.0,-71.23000000000002,71.23000000000002,0.0,32.68904781653478,2295.35,2444.8,20.475075276011943,-79.52492472398805,36.67763167391559,48.61918070753013,-0.0384742581706641,3988510468.0,0
759,2013-02-22,2322.94,2330.88,2308.76,2314.16,96981828.0,-11.789999999999964,11.789999999999964,0.0,30.44145305018344,2308.76,2444.8,3.969420758600145,-96.03057924139983,28.32721780947304,44.56078812791871,-0.0469452051973725,3891528640.0,0
760,2013-02-25,2320.62,2338.78,2315.01,2325.82,88367374.0,11.66000000000031,0.0,11.66000000000031,35.50196956687893,2308.76,2444.8,12.540429285504226,-87.45957071449577,22.392195917850582,40.12706968590509,-0.0441036853764492,3979896014.0,1
761,2013-02-26,2313.74,2340.71,2289.89,2293.34,117638667.0,-32.48000000000002,32.48000000000002,0.0,28.773674252484028,2289.89,2444.8,2.22709960622314,-97.77290039377688,14.896071120506804,35.08086997282543,-0.0579754198021753,3862257347.0,0
762,2013-02-27,2297.77,2324.63,2292.03,2313.22,97824887.0,19.87999999999965,0.0,19.87999999999965,37.18158065135622,2289.89,2444.8,15.060357627009155,-84.93964237299085,10.439152021499469,30.15252638256024,-0.0435429785861661,3960082234.0,1
763,2013-02-28,2322.32,2366.16,2308.92,2365.59,126950494.0,52.370000000000346,0.0,52.370000000000346,53.7694466669758,2289.89,2444.8,48.86708411335622,-51.13291588664378,11.005962960779016,26.323213698203997,-0.027466699555994,4087032728.0,1
764,2013-03-01,2364.54,2369.65,2330.86,2359.51,120312752.0,-6.079999999999927,6.079999999999927,0.0,51.932438275658726,2289.89,2444.8,44.94222451746189,-55.05777548253812,10.839607281173812,23.22649241479796,-0.0256239779315812,3966719976.0,0
765,2013-03-04,2332.08,2333.54,2259.25,2273.4,161750025.0,-86.11000000000013,86.11000000000013,0.0,33.326180546384094,2259.25,2444.8,7.625976825653505,-92.3740231743465,3.716569557481307,19.32450784333463,-0.0459564146358862,3804969951.0,0
766,2013-03-05,2274.81,2328.14,2270.1,2326.31,131136598.0,52.909999999999854,0.0,52.909999999999854,46.83154822092514,2259.25,2444.8,36.14120183239013,-63.85879816760988,2.314228667893076,15.92245200824632,-0.0295639042541652,3936106549.0,1
767,2013-03-06,2333.61,2351.44,2321.6,2347.18,141333692.0,20.86999999999989,0.0,20.86999999999989,51.31941030399759,2259.25,2444.8,47.38884397736446,-52.61115602263554,2.8539988692941733,13.30876138045589,0.0091274532986522,4077440241.0,1
768,2013-03-07,2340.44,2352.02,2304.27,2324.29,139756348.0,-22.889999999999876,22.889999999999876,0.0,46.36649392737484,2259.25,2444.8,35.05254648342759,-64.94745351657241,1.418388641112415,10.930686832587195,0.0043773982784249,3937683893.0,0
769,2013-03-08,2326.42,2333.67,2314.59,2318.61,98794148.0,-5.679999999999836,5.679999999999836,0.0,45.11969633194405,2259.25,2427.07,35.37123108092008,-64.62876891907993,-0.1756465934017796,8.7094201473894,-0.0030999819418527,3838889745.0,0
770,2013-03-11,2314.68,2320.96,2296.58,2310.59,84111903.0,-8.019999999999982,8.019999999999982,0.0,43.225998541170334,2259.25,2397.94,37.01780950320869,-62.98219049679131,-2.062305006842962,6.555075116542927,0.0075217804599405,3754777842.0,0
771,2013-03-12,2309.16,2333.29,2264.83,2286.6,117664456.0,-23.99000000000024,23.99000000000024,0.0,37.756582406328704,2259.25,2378.82,22.873630509324972,-77.12636949067503,-5.430686327836611,4.15792282766702,-0.0115077683921114,3637113386.0,0
772,2013-03-13,2282.17,2286.33,2253.25,2263.97,90972788.0,-22.63000000000011,22.63000000000011,0.0,33.18617102320684,2253.25,2369.65,9.20962199312697,-90.79037800687304,-9.813085524309829,1.3637211572716492,-0.0429575708385647,3546140598.0,0
773,2013-03-14,2255.77,2276.22,2253.31,2270.28,80294086.0,6.3100000000004,0.0,6.3100000000004,35.69071692854848,2253.25,2369.65,14.630584192440024,-85.36941580755997,-12.63139731044339,-1.4353025362713594,-0.0378171739047513,3626434684.0,1
774,2013-03-15,2269.31,2312.08,2250.0,2278.4,116477813.0,8.11999999999989,0.0,8.11999999999989,39.08139946692389,2250.0,2369.65,23.73589636439621,-76.26410363560379,-14.047779509717202,-3.957797930960529,0.0021993489926981,3742912497.0,1
775,2013-03-18,2267.29,2276.05,2239.21,2240.02,93122772.0,-38.38000000000011,38.38000000000011,0.0,30.35335405337689,2239.21,2369.65,0.6209751609935181,-99.37902483900648,-18.05904442926476,-6.778047230621376,-0.0370930787384312,3649789725.0,0
776,2013-03-19,2244.26,2261.31,2232.02,2257.43,87582105.0,17.409999999999854,0.0,17.409999999999854,37.64250972573248,2232.02,2369.65,18.462544503378503,-81.53745549662149,-19.607140369887475,-9.343865858474595,-0.038237374210755,3737371830.0,1
777,2013-03-20,2257.74,2317.86,2257.42,2317.37,131241284.0,59.940000000000055,0.0,59.940000000000055,55.95476472861829,2232.02,2369.65,62.01409576400483,-37.98590423599518,-15.815054393225637,-10.638103565424808,-0.0029772532687402,3868613114.0,1
778,2013-03-21,2318.21,2330.81,2311.6,2324.24,119200910.0,6.869999999999891,0.0,6.869999999999891,57.60138250848165,2232.02,2352.02,76.84999999999982,-23.15000000000017,-12.115784133524812,-10.93363967904481,0.0024281789520443,3987814024.0,1
779,2013-03-22,2321.4,2332.0,2314.97,2328.28,101167299.0,4.040000000000418,0.0,4.040000000000418,58.65029396181205,2232.02,2352.02,80.21666666666685,-19.78333333333315,-8.757144652180614,-10.49834067367197,0.0076560532158453,4088981323.0,1
780,2013-03-25,2334.74,2344.89,2319.91,2326.72,97031526.0,-1.5600000000004002,1.5600000000004002,0.0,58.01087182953928,2232.02,2352.02,78.91666666666652,-21.083333333333485,-6.150379877313753,-9.628748514400328,0.0175457010408466,3991949797.0,0
781,2013-03-26,2318.58,2319.99,2281.12,2297.67,104449015.0,-29.049999999999727,29.049999999999727,0.0,47.00075862940799,2232.02,2352.02,54.70833333333341,-45.29166666666659,-6.355331921195557,-8.974065195759374,0.0148853562547208,3887500782.0,0
782,2013-03-27,2299.38,2323.48,2289.0,2301.26,96331195.0,3.590000000000145,0.0,3.590000000000145,48.39729132899481,2232.02,2344.89,61.3449100735362,-38.6550899264638,-6.157099682969147,-8.41067209320133,0.0136458938985499,3983831977.0,1
783,2013-03-28,2273.55,2273.55,2232.91,2236.3,127658698.0,-64.96000000000004,64.96000000000004,0.0,31.22104230144068,2232.02,2344.89,3.791973066359709,-96.20802693364028,-11.113617448655532,-8.95126116429217,-0.018477879213483,3856173279.0,0
784,2013-03-29,2238.49,2246.87,2228.81,2236.62,85565473.0,0.3199999999997089,0.0,0.3199999999997089,31.35950714968486,2228.81,2344.89,6.728118538938619,-93.27188146106138,-14.844751111815183,-10.129959153796774,-0.0015178435906822,3941738752.0,1
785,2013-04-01,2229.46,2243.95,2227.31,2234.4,77411774.0,-2.2199999999998,2.2199999999998,0.0,30.862158273423745,2227.31,2344.89,6.029937064126679,-93.97006293587332,-17.775927046065135,-11.659152732250448,-0.0102018667245494,3864326978.0,0
786,2013-04-02,2234.9,2253.42,2220.44,2227.74,89714323.0,-6.660000000000309,6.660000000000309,0.0,29.256043184294143,2220.44,2344.89,5.865809562072911,-94.13419043792707,-20.401139791747028,-13.407550144149765,-0.0386774662656373,3774612655.0,0
787,2013-04-03,2232.69,2241.34,2217.25,2225.29,81795267.0,-2.449999999999818,2.449999999999818,0.0,28.62375262141903,2217.25,2344.89,6.298965841428997,-93.701034158571,-22.42088037834401,-15.210216190988614,-0.0425730561387808,3692817388.0,0
788,2013-04-08,2196.24,2212.59,2180.67,2211.59,86257470.0,-13.699999999999818,13.699999999999818,0.0,25.120780862255288,2180.67,2344.89,18.82840092558769,-81.1715990744123,-24.840667101423605,-17.136306373075616,-0.0501185424433487,3606559918.0,0
789,2013-04-09,2215.47,2234.73,2215.47,2225.77,82896544.0,14.179999999999836,0.0,14.179999999999836,34.66920265451532,2180.67,2344.89,27.463159176714143,-72.53684082328586,-25.322258783592133,-18.77349685517892,-0.0433872575986795,3689456462.0,1
790,2013-04-10,2224.93,2233.04,2212.56,2226.13,80619621.0,0.3600000000001273,0.0,0.3600000000001273,34.91233523262653,2180.67,2344.89,27.68237729874564,-72.31762270125436,-25.3822835057058,-20.095254185284297,-0.0311358898362253,3770076083.0,1
791,2013-04-11,2236.98,2242.48,2217.26,2219.55,73632704.0,-6.579999999999927,6.579999999999927,0.0,32.37159321107626,2180.67,2344.89,23.675557179393596,-76.32444282060641,-25.66495491470414,-21.209194331168263,-0.0355066354953373,3696443379.0,0
792,2013-04-12,2218.09,2226.26,2204.44,2206.78,66846340.0,-12.769999999999982,12.769999999999982,0.0,27.83539547249057,2180.67,2344.89,15.89940323955679,-84.10059676044321,-26.612632458338798,-22.289881956602372,-0.0132003756204445,3629597039.0,0
793,2013-04-15,2199.91,2204.99,2177.39,2181.94,71632323.0,-24.840000000000146,24.840000000000146,0.0,21.17546774074721,2177.39,2344.89,2.71641791044787,-97.28358208955214,-29.03337546308603,-23.63858065789911,-0.0244476039738533,3557964716.0,0
794,2013-04-16,2169.63,2196.43,2165.78,2194.85,79992178.0,12.909999999999854,0.0,12.909999999999854,31.066169173221297,2165.78,2323.48,18.43373493975887,-81.56626506024112,-29.569246757824203,-24.82471387788413,-0.0177005012531329,3637956894.0,1
795,2013-04-17,2195.03,2197.51,2178.47,2193.8,68314181.0,-1.0499999999997272,1.0499999999997272,0.0,30.704609297119745,2165.78,2323.48,17.767913760304385,-82.23208623969562,-29.735878151048382,-25.806946732516984,-0.0152351710702324,3569642713.0,0
796,2013-04-18,2181.82,2206.03,2175.44,2197.6,71616927.0,3.799999999999727,0.0,3.799999999999727,33.916267324283524,2165.78,2273.55,29.52584207107703,-70.47415792892298,-29.224425502992744,-26.49044248661214,-0.0124433219939873,3641259640.0,1
797,2013-04-19,2201.12,2250.11,2200.58,2244.64,109660556.0,47.03999999999997,0.0,47.03999999999997,60.23837628213922,2165.78,2253.42,89.98174349612025,-10.01825650387975,-24.73819422029373,-26.13999283334846,0.014943999565923,3750920196.0,1
798,2013-04-22,2236.4,2245.12,2232.26,2242.17,95233730.0,-2.4699999999998,2.4699999999998,0.0,58.81892418553942,2165.78,2253.42,87.16339570972157,-12.83660429027843,-21.13846094501332,-25.13968645568144,0.0073682366102518,3655686466.0,0
799,2013-04-23,2242.62,2242.62,2182.81,2184.54,96541315.0,-57.63000000000011,57.63000000000011,0.0,35.98860222973157,2165.78,2253.42,21.405750798721808,-78.5942492012782,-22.674527912301077,-24.646654747005368,-0.0186826465660137,3559145151.0,0
800,2013-04-24,2187.35,2226.12,2184.11,2218.32,91600261.0,33.7800000000002,0.0,33.7800000000002,49.298499510450085,2165.78,2250.11,62.30285782046722,-37.697142179532776,-20.92489914977932,-23.90230362756016,-0.0005541663850781,3650745412.0,1
801,2013-04-25,2213.19,2224.63,2191.85,2199.31,96704188.0,-19.01000000000022,19.01000000000022,0.0,43.43415889441762,2165.78,2250.11,39.76046484050727,-60.23953515949274,-20.83211423156672,-23.288265748361475,-0.003385022521502,3554041224.0,0
802,2013-04-26,2203.89,2210.58,2173.86,2177.91,76673970.0,-21.40000000000009,21.40000000000009,0.0,37.62119487818755,2165.78,2250.11,14.383967745760303,-85.6160322542397,-22.22913899101195,-23.076440396891574,-0.0018469802102716,3477367254.0,0
803,2013-05-02,2170.78,2179.65,2161.14,2174.12,68337936.0,-3.789999999999964,3.789999999999964,0.0,36.619687403739945,2161.14,2250.11,14.589187366528025,-85.41081263347198,-23.37268672002392,-23.135689661518047,-0.0094448367770006,3409029318.0,0
804,2013-05-03,2179.05,2222.81,2179.05,2205.5,88583464.0,31.38000000000011,0.0,31.38000000000011,49.470444714728,2161.14,2250.11,49.859503203326966,-50.14049679667304,-21.499025405489192,-22.80835681031228,0.0053332117786488,3497612782.0,1
805,2013-05-06,2212.5,2236.07,2212.5,2231.17,92268146.0,25.670000000000076,0.0,25.670000000000076,57.58735175065398,2161.14,2250.11,78.7119253681016,-21.288074631898397,-17.738304712842364,-21.794346390818298,0.0152757553694939,3589880928.0,1
806,2013-05-07,2227.86,2240.26,2219.44,2235.57,86452356.0,4.400000000000091,0.0,4.400000000000091,58.89331881734145,2161.14,2250.11,83.65741261099255,-16.34258738900744,-14.238728048086614,-20.28322272227196,-0.0040407370446929,3676333284.0,1
807,2013-05-08,2242.39,2255.21,2235.42,2246.3,90371933.0,10.730000000000018,0.0,10.730000000000018,62.17093012980215,2161.14,2255.21,90.52832996704598,-9.471670032954012,-10.47867535577825,-18.32231324897322,0.001841965595829,3766705217.0,1
808,2013-05-09,2246.96,2247.86,2221.38,2232.97,98531637.0,-13.330000000000382,13.330000000000382,0.0,55.79401042446648,2161.14,2255.21,76.35803125332178,-23.641968746678216,-8.476711846354192,-16.353192968449413,0.0221694269731842,3668173580.0,0
809,2013-05-10,2228.82,2247.67,2225.81,2246.83,90335476.0,13.860000000000127,0.0,13.860000000000127,60.637786760473965,2161.14,2255.21,91.09174019347284,-8.908259806527155,-5.705980186875422,-14.223750412134612,0.0128520682318149,3758509056.0,1
810,2013-05-13,2247.68,2250.85,2231.36,2241.92,86211224.0,-4.909999999999855,4.909999999999855,0.0,58.03832173561446,2161.14,2255.21,85.87222281279904,-14.127777187200955,-3.861834525610448,-12.15136723482978,0.0193742582901002,3672297832.0,0
811,2013-05-14,2238.9,2239.93,2205.87,2217.01,83244975.0,-24.90999999999985,24.90999999999985,0.0,46.39553448932888,2161.14,2255.21,59.391942170724185,-40.60805782927581,-4.360104055665943,-10.593114598997014,0.0179529916295899,3589052857.0,0
812,2013-05-15,2217.09,2225.19,2213.58,2224.8,71722893.0,7.789999999999964,0.0,7.789999999999964,50.01382674643145,2161.14,2255.21,67.67300946103985,-32.32699053896014,-4.079373869177289,-9.29036645303307,0.0233105808327047,3660775750.0,1
813,2013-05-16,2221.34,2252.87,2210.77,2251.81,110284376.0,27.009999999999764,0.0,27.009999999999764,60.6422331956792,2161.14,2255.21,96.38567024556173,-3.614329754438274,-1.658296100627922,-7.76395238255204,0.0209975062344138,3771060126.0,1
814,2013-05-17,2249.81,2288.09,2248.41,2282.87,126126006.0,31.059999999999945,0.0,31.059999999999945,69.3027297881654,2161.14,2288.09,95.88814493895217,-4.111855061047849,2.7351784599241,-5.664126214056812,0.0231716991533588,3897186132.0,1
815,2013-05-20,2286.33,2309.39,2281.9,2299.99,139150514.0,17.11999999999989,0.0,17.11999999999989,73.07131019849334,2161.14,2309.39,93.65935919055644,-6.34064080944357,7.511887264231518,-3.0289235183991456,0.0288159171933777,4036336646.0,1
816,2013-05-21,2297.11,2305.3,2290.12,2305.11,124173176.0,5.120000000000346,0.0,5.120000000000346,74.16574060967939,2161.14,2309.39,97.1129848229344,-2.8870151770655954,11.577150432686722,-0.1077087281819715,0.0261808306993722,4160509822.0,1
817,2013-05-22,2303.75,2314.18,2292.43,2302.4,128360026.0,-2.7100000000000364,2.7100000000000364,0.0,72.3694546901454,2179.05,2314.18,91.28246873381204,-8.71753126618795,14.414070004180305,2.7966470182904843,0.0310931181341442,4032149796.0,0
818,2013-05-23,2293.81,2304.95,2274.1,2275.67,124019844.0,-26.730000000000015,26.730000000000015,0.0,56.73166883873319,2205.87,2314.18,64.44464961684075,-35.55535038315925,14.340157189776164,5.105349052587622,0.0128358620812434,3908129952.0,0
819,2013-05-24,2281.45,2292.59,2270.25,2288.53,101441213.0,12.860000000000127,0.0,12.860000000000127,61.36592843410115,2205.87,2314.18,76.31797617948514,-23.682023820514864,15.144696640715663,7.113218570213231,0.020790215529546,4009571165.0,1
820,2013-05-27,2286.66,2301.7,2283.94,2293.08,107325061.0,4.549999999999727,0.0,4.549999999999727,62.98442951857974,2205.87,2314.18,80.51888098975172,-19.48111901024829,15.965407644834158,8.883656385137417,0.034311978746149,4116896226.0,1
821,2013-05-28,2293.4,2322.1,2281.47,2321.32,132632995.0,28.24000000000024,0.0,28.24000000000024,71.52682410447522,2205.87,2322.1,99.32891680289104,-0.6710831971089608,18.679236407093867,10.842772389528708,0.043383674937073,4249529221.0,1
822,2013-05-29,2323.54,2334.33,2321.17,2324.02,125250729.0,2.699999999999818,0.0,2.699999999999818,72.23372698173978,2205.87,2334.33,91.97415537910638,-8.025844620893618,20.807971347245257,12.83581218107202,0.0320675367815224,4374779950.0,1
823,2013-05-30,2316.25,2325.72,2310.49,2317.75,111913032.0,-6.269999999999982,6.269999999999982,0.0,67.7282052478341,2205.87,2334.33,87.09325860189948,-12.906741398100516,21.73848480352035,14.616346705561687,0.0152790128215798,4262866918.0,0
824,2013-05-31,2320.74,2325.53,2299.37,2300.59,108162554.0,-17.159999999999854,17.159999999999854,0.0,56.58298683405187,2205.87,2334.33,73.73501479059648,-26.26498520940353,20.85089865326836,15.863257095103023,0.000260870699438,4154704364.0,0
825,2013-06-03,2300.21,2313.43,2294.11,2299.25,96882814.0,-1.3400000000001455,1.3400000000001455,0.0,55.75628618851207,2210.77,2334.33,71.60893493039823,-28.39106506960177,19.81098473323345,16.65280262272911,-0.0025421780305495,4057821550.0,0
826,2013-06-04,2297.1,2297.1,2264.76,2272.42,101895818.0,-26.829999999999927,26.829999999999927,0.0,41.68567342730897,2210.77,2334.33,49.89478795726782,-50.10521204273218,16.630186251915802,16.648279348566447,-0.0130211952744961,3955925732.0,0
827,2013-06-05,2270.71,2276.86,2260.87,2270.93,76483303.0,-1.4900000000002365,1.4900000000002365,0.0,41.02230810181509,2248.41,2334.33,26.21042830540033,-73.78957169459967,13.8297294787817,16.084569374609497,-0.0020829030571217,3879442429.0,0
828,2013-06-06,2264.43,2266.69,2240.07,2242.11,81538694.0,-28.81999999999971,28.81999999999971,0.0,30.2712371077197,2240.07,2334.33,2.164226607256491,-97.8357733927435,9.17900432058468,14.703456363804534,-0.0202837629395289,3797903735.0,0
829,2013-06-07,2242.26,2250.63,2205.07,2210.9,89978077.0,-31.21000000000004,31.21000000000004,0.0,22.80360588284205,2205.07,2334.33,4.510289339316059,-95.48971066068394,2.940983136007617,12.35096171824515,-0.0358382612032723,3707925658.0,0
830,2013-06-13,2190.1,2190.1,2126.22,2148.35,94371094.0,-62.55000000000018,62.55000000000018,0.0,14.520226700345646,2126.22,2334.33,10.633799432992214,-89.3662005670078,-6.969614465994255,8.486846481397269,-0.074513638791722,3613554564.0,0
831,2013-06-14,2150.06,2163.85,2142.78,2162.04,77857472.0,13.690000000000056,0.0,13.690000000000056,21.7027124604452,2126.22,2334.33,17.21205131901405,-82.78794868098595,-13.562822108976434,4.076912763322527,-0.0696981953683703,3691412036.0,1
832,2013-06-17,2165.99,2169.36,2147.03,2156.22,75757790.0,-5.820000000000164,5.820000000000164,0.0,20.84359702213476,2126.22,2334.33,14.415453366008352,-85.58454663399164,-19.038152061637447,-0.5461002016694695,-0.0696925897961385,3615654246.0,0
833,2013-06-18,2158.55,2161.68,2138.35,2159.29,69632271.0,3.070000000000164,0.0,3.070000000000164,22.70588664890748,2126.22,2334.33,15.890634760463286,-84.10936523953671,-22.86608120333358,-5.010096402002294,-0.0614190272929988,3685286517.0,1
834,2013-06-19,2150.82,2150.82,2115.79,2143.45,75425016.0,-15.840000000000146,15.840000000000146,0.0,19.91632994206975,2115.79,2334.33,12.65672188157768,-87.34327811842232,-26.86817860832753,-9.381712843267342,-0.0677612264868979,3609861501.0,0
835,2013-06-20,2132.81,2132.81,2082.82,2084.02,77787930.0,-59.42999999999984,59.42999999999984,0.0,13.001425734711972,2082.82,2334.33,0.4771182060354734,-99.52288179396452,-34.438389639495654,-14.393048202513006,-0.0829072090546642,3532073571.0,0
836,2013-06-21,2058.98,2085.86,2042.88,2073.09,79673224.0,-10.929999999999836,10.929999999999836,0.0,12.109238457634348,2042.88,2325.72,10.68095036062794,-89.31904963937207,-40.848915209334336,-19.68422160387728,-0.087118493304505,3452400347.0,0
837,2013-06-24,2068.86,2068.86,1958.4,1963.23,109198215.0,-109.86000000000011,109.86000000000011,0.0,6.742892815144899,1958.4,2325.53,1.3156102742897409,-98.68438972571026,-54.16965273317555,-26.581307829736936,-0.1243828358109102,3343202132.0,0
838,2013-06-25,1948.31,1963.57,1849.65,1959.51,138158516.0,-3.7200000000000273,3.7200000000000273,0.0,6.628129250063523,1849.65,2313.43,23.687955496140404,-76.3120445038596,-64.28556215802928,-34.12215869539541,-0.113704826088923,3205043616.0,0
839,2013-06-26,1954.47,1959.16,1922.82,1951.49,101192527.0,-8.019999999999982,8.019999999999982,0.0,6.358901865248939,1849.65,2297.1,22.760084925690013,-77.23991507430998,-72.11830530105681,-41.7213880165277,-0.0916331137849977,3103851089.0,0
840,2013-06-27,1955.13,1980.54,1942.37,1950.01,105813318.0,-1.4800000000000182,1.4800000000000182,0.0,6.30437561924235,1849.65,2276.86,23.491959457877837,-76.50804054212217,-77.55127152079558,-48.88736471738128,-0.0980694159219995,2998037771.0,0
841,2013-06-28,1935.52,1987.98,1925.65,1979.21,100737968.0,29.200000000000045,0.0,29.200000000000045,21.607114540114168,1849.65,2266.69,31.06656435833492,-68.93343564166507,-78.59474908303218,-54.82884159051147,-0.0820927363627087,3098775739.0,1
842,2013-07-01,1965.99,1995.92,1957.57,1995.24,78051393.0,16.029999999999973,0.0,16.029999999999973,28.956833721477253,1849.65,2250.63,36.30854406703574,-63.69145593296426,-77.23787538868123,-59.31064835014542,-0.0759740470247164,3176827132.0,1
843,2013-07-02,1992.89,2007.62,1978.43,2006.56,86415418.0,11.319999999999936,0.0,11.319999999999936,33.99887336421911,1849.65,2190.1,46.08899985313554,-53.91100014686446,-74.39157405676906,-62.32683349147016,-0.0638643308684596,3263242550.0,1
844,2013-07-03,1996.51,1996.54,1965.52,1994.27,93466471.0,-12.289999999999964,12.289999999999964,0.0,31.222927863919665,1849.65,2169.36,45.23474398673794,-54.76525601326205,-72.29419752542185,-64.32030629826049,-0.0430658055105037,3169776079.0,0
845,2013-07-04,1982.87,2022.14,1974.1,2006.1,100394183.0,11.829999999999927,0.0,11.829999999999927,36.94129730330751,1849.65,2169.36,48.934972318663725,-51.06502768133628,-68.88338460171144,-65.23292195895068,-0.0323140818777767,3270170262.0,1
846,2013-07-05,2006.19,2021.54,2002.37,2007.2,91345222.0,1.1000000000001364,0.0,1.1000000000001364,37.49883277228563,1849.65,2161.68,50.491939877575895,-49.5080601224241,-65.3383501503522,-65.25400759723098,0.0223967645156197,3361515484.0,1
847,2013-07-08,1983.21,1983.21,1953.12,1958.27,84136491.0,-48.930000000000064,48.930000000000064,0.0,25.79378885892426,1849.65,2150.82,36.06600923066702,-63.93399076933298,-65.7195527864626,-65.3471166350773,-0.0006328112640404,3277378993.0,0
848,2013-07-09,1953.6,1969.15,1946.37,1965.45,64538733.0,7.180000000000064,0.0,7.180000000000064,29.518784901380585,1849.65,2132.81,40.895606724113584,-59.10439327588642,-64.6965115151936,-65.21699561110056,0.0071535083449056,3341917726.0,1
849,2013-07-10,1962.84,2009.36,1960.28,2008.13,89797981.0,42.680000000000064,0.0,42.680000000000064,47.57021172401412,1849.65,2085.86,67.09284111595613,-32.90715888404387,-59.753028906476175,-64.12420227017569,0.0298049753591007,3431715707.0,1
850,2013-07-11,2011.02,2092.87,2010.4,2072.99,159970773.0,64.85999999999967,0.0,64.85999999999967,63.81895298460564,1849.65,2092.87,91.82633007154011,-8.173669928459883,-50.02496670413075,-61.3043551569667,0.0473825415190907,3591686480.0,1
851,2013-07-12,2068.04,2074.86,2036.05,2039.49,121174175.0,-33.49999999999977,33.49999999999977,0.0,53.86947816488718,1849.65,2092.87,78.05279171120799,-21.94720828879201,-44.50554513016664,-57.94459315160669,0.0221777831238347,3470512305.0,0
852,2013-07-15,2046.12,2076.67,2037.25,2059.39,101470357.0,19.899999999999864,0.0,19.899999999999864,58.32299557616513,1922.82,2092.87,80.31167303734195,-19.688326962658056,-38.08656190121837,-53.97298690152903,0.0263286420540627,3571982662.0,1
853,2013-07-16,2054.6,2066.36,2038.54,2065.72,96737399.0,6.329999999999927,0.0,6.329999999999927,59.74921923515267,1925.65,2092.87,83.7639038392536,-16.236096160746396,-32.11845182838215,-49.60207988689965,0.0358276462063811,3668720061.0,1
854,2013-07-17,2061.19,2075.81,2043.23,2044.92,103251321.0,-20.799999999999727,20.799999999999727,0.0,52.88723753987046,1925.65,2092.87,71.32520033488825,-28.67479966511176,-28.73581912939767,-45.42882773539926,0.0193509795124871,3565468740.0,0
855,2013-07-18,2038.4,2043.37,2016.9,2023.4,92132049.0,-21.519999999999985,21.519999999999985,0.0,46.51054357336561,1946.37,2092.87,52.58020477815714,-47.41979522184286,-27.474829759773,-41.83802814027401,0.008070944599442,3473336691.0,0
856,2013-07-19,2025.32,2035.22,1990.25,1992.65,104577571.0,-30.75,30.75,0.0,38.79789394020804,1946.37,2092.87,31.590443686006964,-68.40955631399304,-28.62676310539746,-39.1957751332987,0.0175563124594668,3368759120.0,0
857,2013-07-22,1977.73,2005.47,1970.64,2004.76,82922190.0,12.1099999999999,0.0,12.1099999999999,43.08648399167436,1946.37,2092.87,39.85665529010245,-60.14334470989754,-28.237004181251905,-37.00402094288935,0.0200005087893357,3451681310.0,1
858,2013-07-23,2008.95,2051.53,2005.09,2043.88,109517360.0,39.12000000000012,0.0,39.12000000000012,54.873038496774384,1946.37,2092.87,66.55972696245749,-33.44027303754251,-24.489164520667828,-34.50104965844505,0.0178026322997018,3561198670.0,1
859,2013-07-24,2035.69,2042.77,2010.42,2033.33,106655779.0,-10.550000000000182,10.550000000000182,0.0,51.55096114985215,1946.37,2092.87,59.35836177474405,-40.641638225255946,-22.115339549889317,-32.0239076367339,-0.0191317854885937,3454542891.0,0
860,2013-07-25,2037.34,2045.36,2016.43,2021.17,98545366.0,-12.159999999999854,12.159999999999854,0.0,47.70959682100799,1946.37,2092.87,51.05802047781582,-48.94197952218418,-20.973506999565416,-29.813827509300204,-0.0089826378163168,3355997525.0,0
861,2013-07-26,2013.19,2021.57,2000.8,2010.85,73800429.0,-10.320000000000164,10.320000000000164,0.0,44.4649977744704,1946.37,2092.87,44.01365187713312,-55.98634812286688,-20.66314238606856,-27.98369048465388,-0.023570086287687,3282197096.0,0
862,2013-07-29,1997.84,1997.84,1969.85,1976.31,78683274.0,-34.539999999999964,34.539999999999964,0.0,35.21614871867371,1960.28,2092.87,12.089901199185446,-87.91009880081455,-22.93982945656489,-26.97491827903608,-0.0432827295083553,3203513822.0,0
863,2013-07-30,1981.45,2006.23,1965.36,1990.06,77219784.0,13.75,0.0,13.75,40.86597540982735,1965.36,2092.87,19.371029723159005,-80.62897027684099,-23.365269988075624,-26.25298862084399,-0.0268274553527767,3280733606.0,1
864,2013-07-31,2000.79,2015.47,1987.88,1993.8,70160603.0,3.740000000000009,0.0,3.740000000000009,42.44139214889313,1965.36,2076.67,25.55026502560418,-74.44973497439582,-23.133973880420623,-25.62918567275932,-0.0146288425422557,3350894209.0,1
865,2013-08-01,2000.82,2029.93,1997.06,2029.07,91256686.0,35.26999999999998,0.0,35.26999999999998,55.37727029902492,1965.36,2076.67,57.23654658161884,-42.763453418381154,-19.875562697723357,-24.47846107775213,0.018277168594585,3442150895.0,1
866,2013-08-02,2039.51,2047.08,2025.65,2029.42,93592767.0,0.3500000000001364,0.0,0.3500000000001364,55.49180474274678,1965.36,2075.81,57.99909461294717,-42.00090538705283,-17.06825407654742,-22.996419677511188,0.0123007242762225,3535743662.0,1
867,2013-08-05,2031.72,2050.91,2025.23,2050.48,85517968.0,21.059999999999945,0.0,21.059999999999945,62.2237036166701,1965.36,2075.81,77.06654594839301,-22.933454051606983,-12.994285737147038,-20.99599288943836,0.0032291523964225,3621261630.0,1
868,2013-08-06,2043.65,2066.74,2034.96,2060.5,105580975.0,10.019999999999982,0.0,10.019999999999982,65.11992816877554,1965.36,2066.74,93.8449398303415,-6.155060169658501,-8.855030932920045,-18.567800498134694,0.0133623169874048,3726842605.0,1
869,2013-08-07,2056.37,2069.56,2043.75,2046.78,107712594.0,-13.720000000000027,13.720000000000027,0.0,58.08425620034797,1965.36,2069.56,78.13819577735129,-21.86180422264872,-6.605585933221391,-16.175357585152035,0.0126708787484475,3619130011.0,0
870,2013-08-08,2044.44,2058.56,2037.25,2044.9,84133290.0,-1.8799999999998815,1.8799999999998815,0.0,57.10871480803056,1965.36,2069.56,76.333973128599,-23.666026871401,-4.917894427096371,-13.9238649535409,0.0169331377278265,3534996721.0,0
871,2013-08-09,2052.24,2061.71,2030.13,2052.24,95316423.0,7.339999999999691,0.0,7.339999999999691,60.12565659959571,1965.36,2069.56,83.37811900191923,-16.621880998080766,-2.9540575556070507,-11.729903473954131,0.038420085917695,3630313144.0,1
872,2013-08-12,2058.42,2102.35,2055.72,2101.28,135128974.0,49.04000000000042,0.0,49.04000000000042,74.14535683887878,1965.36,2102.35,99.2189210891308,-0.781078910869194,2.530248341492779,-8.87787311086475,0.0558877621780249,3765442118.0,1
873,2013-08-13,2101.32,2106.4,2093.8,2106.16,117708875.0,4.879999999999654,0.0,4.879999999999654,75.14861576989924,1965.36,2106.4,99.82983550765724,-0.1701644923427652,7.187522211397209,-5.664794046412357,0.0563546995686627,3883150993.0,1
874,2013-08-14,2109.23,2122.97,2093.04,2100.14,114437802.0,-6.019999999999982,6.019999999999982,0.0,71.21518364039441,1965.36,2122.97,85.5148784975573,-14.485121502442702,10.274246500223851,-2.4769859370851144,0.035025898564367,3768713191.0,0
875,2013-08-15,2099.28,2108.41,2079.97,2081.88,99396656.0,-18.259999999999764,18.259999999999764,0.0,60.18911220691776,1965.36,2122.97,73.92931920563434,-26.070680794365657,11.118896623946055,0.2421905751211207,0.0258497501749268,3669316535.0,0
876,2013-08-16,2075.98,2198.85,2061.65,2068.45,153063326.0,-13.430000000000293,13.430000000000293,0.0,53.19913271328959,1965.36,2198.85,44.15178380230413,-55.84821619769586,10.582609437414703,2.310274347579838,0.0087638016464437,3516253209.0,0
877,2013-08-19,2055.13,2091.13,2052.7,2085.6,97446783.0,17.15000000000009,0.0,17.15000000000009,60.03742213909759,1987.88,2198.85,46.31938190264013,-53.68061809735987,11.40993304412268,4.130206086888407,0.0121815093423924,3613699992.0,1
878,2013-08-20,2081.97,2098.98,2066.07,2072.59,107381773.0,-13.009999999999764,13.009999999999764,0.0,53.22960475992487,1997.06,2198.85,37.4300014866942,-62.569998513305805,10.890258570242622,5.482216583559251,0.012610050909233,3506318219.0,0
879,2013-08-21,2076.27,2076.32,2056.91,2072.96,87445991.0,0.3699999999998908,0.0,0.3699999999998908,53.40299163916696,2025.23,2198.85,27.491072457090223,-72.50892754290977,10.388516363410872,6.463476539529577,0.013721942393271,3593764210.0,1
880,2013-08-22,2069.31,2083.33,2062.37,2067.12,90928307.0,-5.8400000000001455,5.8400000000001455,0.0,50.02548998202389,2025.23,2198.85,24.127404676880484,-75.87259532311951,9.41115689807657,7.053012611238977,0.0072506139632793,3502835903.0,0
881,2013-08-23,2075.93,2079.85,2029.36,2057.46,112426351.0,-9.659999999999854,9.659999999999854,0.0,44.63733113953717,2029.36,2198.85,16.57914921234299,-83.420850787657,7.767571483377651,7.195924385666711,-0.0208539556841544,3390409552.0,0
882,2013-08-26,2061.42,2097.34,2056.13,2096.47,119932652.0,39.00999999999976,0.0,39.00999999999976,63.13763792812795,2029.36,2198.85,39.59525635730716,-60.40474364269285,9.503251611652104,7.657389830863789,-0.004600790063433,3510342204.0,1
883,2013-08-27,2095.44,2105.38,2090.43,2103.57,126341966.0,7.100000000000364,0.0,7.100000000000364,65.55487883052365,2029.36,2198.85,43.78429405864669,-56.21570594135332,11.321197562731411,8.390151377237315,0.0016332244517034,3636684170.0,1
884,2013-08-28,2092.31,2113.82,2080.86,2101.3,161392026.0,-2.269999999999982,2.269999999999982,0.0,64.00650332851787,2029.36,2198.85,42.4449820048382,-57.5550179951618,12.43541507354621,9.199204116499097,0.0093281072876438,3475292144.0,0
885,2013-08-29,2108.44,2110.89,2088.24,2097.23,133268219.0,-4.070000000000164,4.070000000000164,0.0,61.024605807614186,2029.36,2198.85,40.0436603929436,-59.9563396070564,12.84199101422928,9.927761496045132,0.013913800188547,3342023925.0,0
886,2013-08-30,2097.22,2114.39,2089.09,2098.38,170075649.0,1.150000000000091,0.0,1.150000000000091,61.6077335459636,2029.36,2198.85,40.72216649949862,-59.27783350050139,13.105923833690667,10.56339396357424,0.0061277330264672,3512099574.0,1
887,2013-09-02,2104.09,2108.68,2078.46,2098.45,149158524.0,0.0699999999997089,0.0,0.0699999999997089,61.64803390575184,2029.36,2198.85,40.76346687120179,-59.23653312879821,13.168937594422914,11.084502689743976,0.0124771421265179,3661258098.0,1
888,2013-09-03,2100.45,2123.85,2095.46,2123.11,138893175.0,24.66000000000031,0.0,24.66000000000031,73.11813983906123,2029.36,2198.85,55.31299781698048,-44.68700218301952,15.03541347426335,11.874684846647853,0.0241924590923123,3800151273.0,1
889,2013-09-04,2121.68,2133.0,2115.75,2127.62,142000386.0,4.509999999999764,0.0,4.509999999999764,74.71398780904933,2029.36,2198.85,57.97392176529588,-42.02607823470412,16.68618046303527,12.836983969925338,0.029267773520647,3942151659.0,1
890,2013-09-05,2125.25,2127.85,2115.24,2122.43,126544104.0,-5.190000000000055,5.190000000000055,0.0,69.25488430297324,2029.36,2133.0,89.80123504438427,-10.198764955615742,17.37534342616982,13.744655861174238,0.031577770649247,3815607555.0,0
891,2013-09-06,2119.33,2143.24,2119.02,2139.99,143260660.0,17.559999999999945,0.0,17.559999999999945,76.07847947528751,2029.36,2143.24,97.14611872146118,-2.853881278538816,19.118074027757302,14.81933949449085,0.0207587039165835,3958868215.0,1
892,2013-09-09,2151.35,2218.53,2151.35,2212.52,219427086.0,72.5300000000002,0.0,72.5300000000002,88.374847500336,2029.36,2218.53,96.8229634720092,-3.1770365279908064,26.051460407602008,17.065763677113083,0.0517929044433984,4178295301.0,1
893,2013-09-10,2214.81,2238.55,2202.82,2237.98,237206649.0,25.46000000000004,0.0,25.46000000000004,90.37810704738516,2029.36,2238.55,99.72752043596722,-0.2724795640327754,33.21771514500051,20.29615397069057,0.0650454480559652,4415501950.0,1
894,2013-09-11,2244.96,2258.07,2233.0,2241.27,244349455.0,3.289999999999964,0.0,3.289999999999964,90.619134698181,2029.36,2258.07,92.65445323772455,-7.345546762275442,38.716202872079066,23.98016375096827,0.068681069792059,4659851405.0,1
895,2013-09-12,2236.17,2270.27,2226.29,2255.6,209715110.0,14.329999999999927,0.0,14.329999999999927,91.66807312553384,2056.13,2270.27,93.14934155225548,-6.850658447744504,43.72605846597799,27.929342693970213,0.0749244655400831,4869566515.0,1
896,2013-09-13,2251.46,2259.42,2228.48,2236.22,171984229.0,-19.38000000000011,19.38000000000011,0.0,78.0494705507343,2078.46,2270.27,82.2480579740367,-17.751942025963295,45.606873435943726,31.46484884236492,0.0656532202339821,4697582286.0,0
897,2013-09-16,2244.46,2248.47,2226.17,2231.4,154884020.0,-4.819999999999709,4.819999999999709,0.0,74.85797889461506,2078.46,2270.27,79.73515458005322,-20.264845419946774,46.176208544196925,34.40712078273132,0.0510053647714907,4542698266.0,0
898,2013-09-17,2230.39,2230.93,2184.92,2185.56,154542555.0,-45.84000000000015,45.84000000000015,0.0,51.67203446477441,2078.46,2270.27,55.83650487461548,-44.16349512538453,42.43929207864949,36.013555041914955,0.0272323065209012,4388155711.0,0
899,2013-09-18,2185.94,2195.9,2172.04,2191.85,115111887.0,6.289999999999964,0.0,6.289999999999964,53.93119743344853,2078.46,2270.27,59.1157916688389,-40.88420833116109,39.52963624862059,36.71677128325609,0.0327077924831442,4503267598.0,1
900,2013-09-23,2199.36,2223.07,2198.34,2221.04,133174858.0,29.19000000000005,0.0,29.19000000000005,63.154133161032405,2078.46,2270.27,74.33397633074395,-25.66602366925605,39.128058190921365,37.19902866478915,0.0378740087570503,4636442456.0,1
901,2013-09-24,2219.47,2219.54,2187.24,2207.53,160415055.0,-13.509999999999764,13.509999999999764,0.0,57.054276606836375,2095.46,2270.27,64.10960471368927,-35.89039528631074,37.28980691277093,37.21718431438551,-0.0022553468443221,4476027401.0,0
902,2013-09-25,2206.23,2217.97,2193.72,2198.51,160212762.0,-9.019999999999982,9.019999999999982,0.0,53.10301217326468,2115.24,2270.27,53.71218473843793,-46.28781526156207,34.705082328318895,36.714763917172185,-0.017636440003932,4315814639.0,0
903,2013-09-26,2192.23,2192.23,2154.72,2155.81,140415346.0,-42.70000000000027,42.70000000000027,0.0,38.52837313901357,2115.24,2270.27,26.16912855576347,-73.83087144423652,28.87824588946569,35.14746031163089,-0.0381301672712346,4175399293.0,0
904,2013-09-27,2150.96,2165.78,2149.59,2160.03,105401788.0,4.220000000000255,0.0,4.220000000000255,40.39390139226139,2119.02,2270.27,27.114049586777007,-72.885950413223,24.32060200273509,32.982088649851725,-0.0423701010817519,4280801081.0,1
905,2013-09-30,2167.73,2176.3,2165.16,2174.67,92810081.0,14.639999999999873,0.0,14.639999999999873,46.85048742573382,2149.59,2270.27,20.78223400729198,-79.21776599270802,21.64050377805688,30.713771675492755,-0.0275241255332658,4373611162.0,1
906,2013-10-08,2171.9,2200.02,2161.49,2198.2,126710203.0,23.529999999999745,0.0,23.529999999999745,55.74126933046304,2149.59,2270.27,40.28007954922087,-59.71992045077914,21.17113333105226,28.805244006604656,-0.0148785515819666,4500321365.0,1
907,2013-10-09,2191.39,2212.35,2185.18,2211.77,130871737.0,13.570000000000164,0.0,13.570000000000164,60.17438432060418,2149.59,2270.27,51.52469340404369,-48.47530659595631,21.644633598144992,27.373121924912724,0.0119923497867824,4631193102.0,1
908,2013-10-10,2214.41,2214.59,2186.48,2190.93,149775896.0,-20.840000000000146,20.840000000000146,0.0,51.10391093183037,2149.59,2270.27,34.255883327808874,-65.74411667219113,20.10649695728398,25.919796931386973,-0.0004197367520587,4481417206.0,0
909,2013-10-11,2201.41,2228.87,2200.53,2228.15,156892176.0,37.220000000000255,0.0,37.220000000000255,62.692712628502136,2149.59,2259.42,71.52872621323864,-28.47127378676136,21.641387088150623,25.064114962739705,0.0032012030400172,4638309382.0,1
910,2013-10-14,2232.22,2242.98,2226.4,2237.77,165983386.0,9.61999999999989,0.0,9.61999999999989,65.15559712131116,2149.59,2248.47,89.1788025889969,-10.82119741100309,23.36471824950604,24.724235620092976,0.0136985680828798,4804292768.0,1
911,2013-10-15,2237.93,2240.25,2221.14,2233.41,153722825.0,-4.360000000000127,4.360000000000127,0.0,62.98128826135606,2149.59,2242.98,89.75265017667826,-10.247349823321745,24.10083561809506,24.5995556196934,0.0158743876534559,4650569943.0,0
912,2013-10-16,2228.11,2228.11,2183.4,2193.07,154638637.0,-40.33999999999969,40.33999999999969,0.0,46.43748074068486,2149.59,2242.98,46.55744726416113,-53.44255273583888,21.184906654817496,23.91662582671822,0.0172835268414193,4495931306.0,0
913,2013-10-17,2201.71,2211.03,2183.25,2188.54,126767944.0,-4.5300000000002,4.5300000000002,0.0,44.90897427681104,2149.59,2242.98,41.70682085876418,-58.29317914123582,18.297555966724303,22.79281185471944,0.0131988907561468,4369163362.0,0
914,2013-10-18,2188.71,2203.29,2184.36,2193.78,103724631.0,5.2400000000002365,0.0,5.2400000000002365,47.22737404906394,2149.59,2242.98,47.31769996787677,-52.68230003212323,16.244873165891022,21.48322411695376,0.0087875401785098,4472887993.0,1
915,2013-10-21,2198.11,2230.28,2190.39,2229.24,136694408.0,35.45999999999958,0.0,35.45999999999958,60.279415597926096,2149.59,2242.98,85.28750401541893,-14.712495984581064,17.28023708927367,20.64262671141774,0.0141206441634063,4609582401.0,1
916,2013-10-22,2227.34,2227.34,2204.24,2210.65,149132831.0,-18.58999999999969,18.58999999999969,0.0,52.43470169611588,2149.59,2242.98,65.38173251954174,-34.618267480458265,16.411530908570512,19.796407550848297,-0.0005063817666393,4460449570.0,0
917,2013-10-23,2213.27,2226.85,2177.73,2183.11,146347090.0,-27.539999999999964,27.539999999999964,0.0,42.89297993238077,2149.59,2242.98,35.89249384302391,-64.10750615697609,13.346971582850529,18.506520357248743,-0.0035692605423266,4314102480.0,0
918,2013-10-24,2178.82,2183.41,2159.87,2164.32,103008953.0,-18.789999999999964,18.789999999999964,0.0,37.518199946953416,2159.87,2242.98,5.354349657081297,-94.64565034291871,9.294943944946226,16.66420507478824,-0.0286470839036868,4211093527.0,0
919,2013-10-25,2163.69,2170.61,2122.68,2132.96,113924520.0,-31.360000000000127,31.360000000000127,0.0,30.22473155837497,2122.68,2242.98,8.545303408146454,-91.45469659185356,3.512700707899512,14.033904201410492,-0.0468368062848282,4097169007.0,0
920,2013-10-28,2135.88,2140.96,2123.07,2133.87,88401322.0,0.9099999999998544,0.0,0.9099999999998544,30.67595252077696,2122.68,2242.98,9.301745635910256,-90.69825436408976,-0.9849850271989452,11.030126355688603,-0.0445686192862035,4185570329.0,1
921,2013-10-29,2135.23,2163.66,2093.2,2128.86,143092811.0,-5.009999999999764,5.009999999999764,0.0,29.465505226835678,2093.2,2242.98,23.808252103084698,-76.1917478969153,-4.897246101395922,7.844651864271699,-0.0292785911986394,4042477518.0,0
922,2013-10-30,2126.69,2161.94,2121.84,2160.46,119643362.0,31.59999999999991,0.0,31.59999999999991,45.20205057675855,2093.2,2242.98,44.905861930831975,-55.09413806916803,-5.385801118485688,5.198561267720222,-0.0128304714558563,4162120880.0,1
923,2013-10-31,2155.51,2155.51,2137.47,2141.61,108063020.0,-18.84999999999991,18.84999999999991,0.0,39.18480536107173,2093.2,2242.98,32.32073708105238,-67.67926291894763,-7.210899196052651,2.716669174965647,-0.0237808713726992,4054057860.0,0
924,2013-11-01,2139.88,2157.31,2132.63,2149.56,89118477.0,7.949999999999818,0.0,7.949999999999818,42.88475088366957,2093.2,2240.25,38.3270996259776,-61.6729003740224,-7.924455818692422,0.5884441762340326,-0.035743123216881,4143176337.0,1
925,2013-11-04,2156.09,2160.58,2143.21,2149.63,76147941.0,0.0700000000001637,0.0,0.0700000000001637,42.92003228005557,2093.2,2230.28,41.16574263203978,-58.83425736796022,-8.3876189182688,-1.2067684426665346,-0.0276027412751905,4219324278.0,1
926,2013-11-05,2139.84,2158.15,2124.84,2157.24,91900031.0,7.609999999999673,0.0,7.609999999999673,47.02490730185395,2093.2,2230.28,46.71724540414341,-53.2827545958566,-8.047845062742908,-2.5749837666818096,-0.011850067106101,4311224309.0,1
927,2013-11-06,2149.39,2166.17,2138.78,2139.61,100487344.0,-17.629999999999654,17.629999999999654,0.0,39.44265951461962,2093.2,2230.28,33.85614239859949,-66.14385760140051,-9.09630890741346,-3.8792487948281407,-0.0114169808531086,4210736965.0,0
928,2013-11-07,2136.63,2141.6,2119.19,2129.4,81842610.0,-10.210000000000036,10.210000000000036,0.0,35.60630870077698,2093.2,2230.28,26.407936971111884,-73.5920630288881,-10.628566234065149,-5.229112282675543,-0.0016690420823644,4128894355.0,0
929,2013-11-08,2120.92,2128.58,2103.51,2106.13,83096859.0,-23.269999999999985,23.269999999999985,0.0,28.35388398040284,2093.2,2227.34,9.639182943193871,-90.36081705680613,-13.56422577792,-6.896134981724435,-0.0129998547240458,4045797496.0,0
930,2013-11-11,2103.3,2117.28,2093.63,2109.47,69678299.0,3.3399999999996908,0.0,3.3399999999996908,30.69185197335432,2093.2,2226.85,12.173587729143264,-87.82641227085674,-15.443227121077598,-8.60555340959507,-0.0091081611754649,4115475795.0,1
931,2013-11-12,2110.72,2127.94,2108.4,2126.77,79446731.0,17.300000000000182,0.0,17.300000000000182,42.00283209576063,2093.2,2183.41,37.213169271699535,-62.78683072830047,-15.35933099824024,-9.956308927324104,-0.0155939012987974,4194922526.0,1
932,2013-11-13,2117.89,2117.91,2086.01,2087.94,88257094.0,-38.82999999999993,38.82999999999993,0.0,29.524274789280557,2086.01,2170.61,2.281323877068367,-97.71867612293164,-18.216115164128496,-11.608270174684984,-0.0250605852606217,4106665432.0,0
933,2013-11-14,2087.12,2102.38,2078.99,2100.51,83799373.0,12.570000000000164,0.0,12.570000000000164,36.56373271831692,2078.99,2166.17,24.68456067905525,-75.31543932094476,-19.2440102779824,-13.135418195344467,-0.022818623346173,4190464805.0,1
934,2013-11-15,2100.9,2153.21,2100.79,2135.83,125894520.0,35.31999999999971,0.0,35.31999999999971,52.08168808252008,2078.99,2166.17,65.19844000917637,-34.801559990823634,-17.01248638965717,-13.91083183420701,-0.0064197094383685,4316359325.0,1
935,2013-11-18,2147.37,2198.32,2143.77,2197.22,157502714.0,61.38999999999987,0.0,61.38999999999987,67.85286241022219,2078.99,2198.32,99.0781865415232,-0.9218134584767956,-10.173058996928376,-13.16327726675128,0.0185329402384528,4473862039.0,1
936,2013-11-19,2198.32,2203.3,2186.11,2193.12,125082307.0,-4.099999999999909,4.099999999999909,0.0,66.17449405806346,2078.99,2203.3,91.81079559166578,-8.189204408334211,-5.025666492687833,-11.535755111938592,0.0250092306541844,4348779732.0,0
937,2013-11-20,2201.47,2207.1,2186.64,2206.61,118961861.0,13.490000000000236,0.0,13.490000000000236,69.0782442619303,2078.99,2207.1,99.61751619701836,-0.3824838029816417,0.1405887911778336,-9.20048633131531,0.0362590401051938,4467741593.0,1
938,2013-11-21,2197.01,2206.53,2177.74,2205.77,137245516.0,-0.8400000000001455,0.8400000000001455,0.0,68.65479530072436,2078.99,2207.1,98.96182967762086,-1.0381703223791476,4.119613998865589,-6.536466265279129,0.0473095203050144,4330496077.0,0
939,2013-11-22,2206.47,2211.07,2188.77,2196.38,113866457.0,-9.389999999999873,9.389999999999873,0.0,63.624232763211054,2078.99,2211.07,88.8779527559055,-11.122047244094498,6.441076893790523,-3.940957633465199,0.0411999222553534,4216629620.0,0
940,2013-11-25,2186.06,2209.15,2181.42,2186.11,108282655.0,-10.269999999999982,10.269999999999982,0.0,58.23891074296503,2078.99,2211.07,81.10236220472443,-18.897637795275564,7.3672250092581635,-1.6793211049205257,0.0279014656027685,4108346965.0,0
941,2013-11-26,2184.33,2192.58,2176.18,2183.07,100460830.0,-3.039999999999964,3.039999999999964,0.0,56.6025605797524,2078.99,2211.07,78.80072683222295,-21.199273167777044,7.766375526969114,0.2098182214574028,0.0455616540705192,4007886135.0,0
942,2013-11-27,2181.73,2207.62,2176.85,2201.07,115384411.0,18.0,0.0,18.0,63.5915180831058,2078.99,2211.07,92.4288310115082,-7.571168988491801,9.426492023443643,2.053152981854652,0.0478740877215533,4123270546.0,1
943,2013-11-28,2204.38,2234.39,2202.62,2219.37,134456777.0,18.299999999999727,0.0,18.299999999999727,69.37680929167806,2078.99,2234.39,90.33462033462035,-9.665379665379648,12.079557745486,4.058433934580922,0.0391135998651577,4257727323.0,1
944,2013-11-29,2221.62,2224.94,2212.26,2220.5,106959053.0,1.1300000000001091,0.0,1.1300000000001091,69.71962378981704,2078.99,2234.39,91.06177606177614,-8.938223938223851,14.110654163091567,6.068877980283052,0.010595206670247,4364686376.0,1
945,2013-12-02,2203.12,2231.92,2172.63,2207.37,174281990.0,-13.13000000000011,13.13000000000011,0.0,60.62117635037005,2078.99,2234.39,82.61261261261264,-17.387387387387363,14.493756437134834,7.75385367165341,0.0064975924710002,4190404386.0,0
946,2013-12-03,2196.82,2227.93,2193.25,2222.67,113506410.0,15.300000000000182,0.0,15.300000000000182,66.49932339013958,2078.99,2234.39,92.4581724581726,-7.541827541827409,15.849249598426468,9.372932857008022,0.0072781325200192,4303910796.0,1
947,2013-12-04,2219.97,2260.87,2215.92,2251.76,157292943.0,29.090000000000146,0.0,29.090000000000146,74.76360662115626,2100.79,2260.87,94.30909545227406,-5.690904547725935,19.051197236493863,11.308585732905192,0.0208498619529688,4461203739.0,1
948,2013-12-05,2252.72,2255.26,2239.14,2247.06,122048414.0,-4.700000000000273,4.700000000000273,0.0,71.47647724453316,2143.77,2260.87,88.20666097352694,-11.793339026473063,20.9678092351337,13.240430433350893,0.0230743313998487,4339155325.0,0
949,2013-12-06,2242.56,2248.15,2228.63,2237.11,103700929.0,-9.949999999999818,9.949999999999818,0.0,64.54447411467797,2172.63,2260.87,73.07343608340908,-26.92656391659091,21.436746735661927,14.8796936938131,0.0233291096971333,4235454396.0,0
950,2013-12-09,2241.79,2249.17,2231.73,2238.2,93273639.0,1.0899999999996908,0.0,1.0899999999996908,64.97385164817513,2172.63,2260.87,74.30870353581128,-25.691296464188724,21.646806068147725,16.233116168680027,0.025253427512631,4328728035.0,1
951,2013-12-10,2239.86,2250.5,2231.68,2237.49,109043133.0,-0.7100000000000364,0.7100000000000364,0.0,64.387796205043,2172.63,2260.87,73.50407978241141,-26.495920217588587,21.508057042965447,17.28810434353711,0.0165464978396869,4219684902.0,0
952,2013-12-11,2228.63,2228.63,2193.16,2204.17,109473150.0,-33.31999999999971,33.31999999999971,0.0,43.25911885311359,2172.63,2260.87,35.74342701722579,-64.2565729827742,18.496238780580825,17.529731230945853,-0.0068487904225071,4110211752.0,0
953,2013-12-12,2199.32,2214.55,2194.9,2202.8,86108671.0,-1.3699999999998909,1.3699999999998909,0.0,42.59598545447212,2172.63,2260.87,34.1908431550319,-65.8091568449681,15.816481010557707,17.187081186868223,-0.0079711776626885,4024103081.0,0
954,2013-12-13,2188.26,2204.64,2183.84,2196.07,85101012.0,-6.730000000000018,6.730000000000018,0.0,39.1907351054777,2172.63,2260.87,26.563916591115262,-73.43608340888473,12.999844797456262,16.34963390898583,-0.0051192142685638,3939002069.0,0
955,2013-12-16,2197.23,2201.7,2159.99,2160.86,101387594.0,-35.21000000000004,35.21000000000004,0.0,26.433948649567867,2159.99,2260.87,0.8624107850915391,-99.13758921490846,7.836157225397528,14.64693857226817,-0.0278088965073537,3837614475.0,0
956,2013-12-17,2161.54,2165.54,2146.31,2151.08,78578936.0,-9.7800000000002,9.7800000000002,0.0,23.936798396859142,2146.31,2260.87,4.1637569832402095,-95.8362430167598,2.9210611820421946,12.301763094222974,-0.0447116921874446,3759035539.0,0
957,2013-12-18,2150.41,2156.59,2142.62,2148.28,64173584.0,-2.799999999999727,2.799999999999727,0.0,23.21241248535796,2142.62,2260.87,4.786469344609141,-95.21353065539084,-1.186447811265225,9.604120913125335,-0.0439596628483439,3694861955.0,0
958,2013-12-19,2153.67,2159.14,2126.25,2127.79,73123479.0,-20.49000000000024,20.49000000000024,0.0,18.48819155726653,2126.25,2260.87,1.1439607784875687,-98.85603922151245,-6.025590779682716,6.478178574563724,-0.0488666180920921,3621738476.0,0
959,2013-12-20,2128.37,2131.74,2082.85,2084.79,86775212.0,-43.0,43.0,0.0,12.384780336066456,2082.85,2260.87,1.0897651949219496,-98.91023480507803,-13.17847383722119,2.5468480922067407,-0.0685416852828164,3534963264.0,0
960,2013-12-23,2089.54,2099.52,2068.54,2089.71,68146636.0,4.920000000000073,0.0,4.920000000000073,16.043887060058623,2068.54,2260.87,11.007123173711893,-88.9928768262881,-18.23992382432698,-1.6105062911000043,-0.0660472225574191,3603109900.0,1
961,2013-12-24,2094.07,2111.8,2079.81,2092.91,70251467.0,3.199999999999818,0.0,3.199999999999818,18.595283088303347,2068.54,2255.26,13.051628106255276,-86.94837189374472,-21.742314283463656,-5.636867889572736,-0.0504770503182604,3673361367.0,1
962,2013-12-25,2095.02,2107.23,2088.3,2106.35,65139096.0,13.440000000000056,0.0,13.440000000000056,29.04502575903525,2068.54,2250.5,20.77929215212131,-79.22070784787869,-23.166439978987,-9.14278230745559,-0.0437851824950065,3738500463.0,1
963,2013-12-26,2102.66,2102.66,2070.55,2073.1,78541408.0,-33.25,33.25,0.0,21.2560693732968,2068.54,2250.5,2.5060452846779206,-97.49395471532208,-26.670624612470878,-12.648350768458648,-0.0559954828398002,3659959055.0,0
964,2013-12-27,2074.59,2110.36,2069.59,2101.25,76756827.0,28.15000000000009,0.0,28.15000000000009,37.60209486402814,2068.54,2250.5,17.976478346889444,-82.02352165311055,-26.866545626027342,-15.491989739972391,-0.0275862388123248,3736715882.0,1
965,2013-12-30,2108.88,2112.01,2095.06,2097.53,74085056.0,-3.7199999999998,3.7199999999998,0.0,36.44841277414013,2068.54,2228.63,18.108563932787938,-81.89143606721207,-27.01062567224926,-17.79571692642777,-0.0248944716142587,3662630826.0,0
966,2013-12-31,2090.68,2120.27,2087.42,2115.98,80474375.0,18.449999999999815,0.0,18.449999999999815,45.940235093293744,2068.54,2214.55,32.49092527909046,-67.50907472090954,-25.34390062957709,-19.305353667057634,-0.0150352840411864,3743105201.0,1
967,2014-01-02,2112.13,2113.11,2101.02,2109.39,68485486.0,-6.5900000000001455,6.5900000000001455,0.0,43.27637723825816,2068.54,2204.64,30.014695077149103,-69.98530492285089,-24.27494054623457,-20.299271042893025,-0.0086474699100945,3674619715.0,0
968,2014-01-03,2101.54,2102.17,2075.9,2083.14,84497241.0,-26.25,26.25,0.0,34.169851409120895,2068.54,2201.7,10.964253529588408,-89.0357464704116,-25.25481580234828,-21.29037999478408,-0.0007914466205229,3590122474.0,0
969,2014-01-06,2078.68,2078.68,2034.01,2045.71,89587608.0,-37.42999999999984,37.42999999999984,0.0,25.38224970686511,2034.01,2165.54,8.895309054968486,-91.10469094503152,-28.720589113521328,-22.77642181853153,-0.0210555531628791,3500534866.0,0
970,2014-01-07,2034.22,2052.28,2029.25,2047.32,63402938.0,1.6099999999999,0.0,1.6099999999999,26.32265528283041,2029.25,2159.14,13.911771498960624,-86.08822850103938,-30.980205364571702,-24.41717852773957,-0.0217830675948798,3563937804.0,1
971,2014-01-08,2047.26,2062.95,2037.11,2044.34,71647364.0,-2.980000000000018,2.980000000000018,0.0,25.63272359247675,2029.25,2159.14,11.617522519054534,-88.38247748094547,-32.63523000155328,-26.06078882250232,-0.029439551831367,3492290440.0,0
972,2014-01-09,2041.77,2057.2,2026.45,2027.62,75941883.0,-16.720000000000027,16.720000000000027,0.0,21.914204445017177,2026.45,2131.74,1.1112166397567178,-98.88878336024328,-34.89377944646367,-27.827386947294592,-0.0219381602431142,3416348557.0,0
973,2014-01-10,2023.54,2029.3,2008.01,2013.3,75616121.0,-14.319999999999936,14.319999999999936,0.0,19.166484968033277,2008.01,2120.27,4.712275075717053,-95.28772492428294,-37.40798451644878,-29.743506461125435,-0.0418560380725758,3340732436.0,0
974,2014-01-13,2014.98,2027.18,2000.4,2009.56,66544776.0,-3.740000000000009,3.740000000000009,0.0,18.46864133343109,2000.4,2120.27,7.641611746058115,-92.35838825394188,-39.24984906397049,-31.644774981694447,-0.0419398053901495,3274187660.0,0
975,2014-01-14,2007.16,2027.43,2001.14,2026.84,70366614.0,17.279999999999973,0.0,17.279999999999973,31.72175801884343,2000.4,2120.27,22.05722866438629,-77.9427713356137,-38.86715206770941,-33.08925039889745,-0.0421270522405694,3344554274.0,1
976,2014-01-15,2024.23,2027.41,2010.2,2023.35,67436222.0,-3.490000000000009,3.490000000000009,0.0,30.5639606211691,2000.4,2120.27,19.145741219654493,-80.85425878034552,-38.40279228924055,-34.15195877696607,-0.0407890432779144,3277118052.0,0
977,2014-01-16,2022.54,2034.71,2014.41,2023.7,72755719.0,0.3500000000001364,0.0,0.3500000000001364,30.85598589103321,2000.4,2120.27,19.437724201217964,-80.56227579878204,-37.57341876150304,-34.836250773873466,-0.0285338479410888,3349873771.0,1
978,2014-01-17,2017.52,2017.87,2001.33,2004.95,67305720.0,-18.75,18.75,0.0,24.489537639166382,2000.4,2120.27,3.7957787603236497,-96.20422123967634,-37.99116407439829,-35.46723343397843,-0.0199246227471147,3282568051.0,0
979,2014-01-20,2001.89,2005.94,1984.82,1991.25,56271247.0,-13.700000000000044,13.700000000000044,0.0,20.86079731088053,1984.82,2120.27,4.747139165743863,-95.25286083425614,-38.97838716484989,-36.16946418015272,-0.027387023034992,3226296804.0,0
980,2014-01-21,1992.02,2014.15,1992.02,2008.31,59844911.0,17.059999999999945,0.0,17.059999999999945,34.75223807753491,1984.82,2113.11,18.31007872788212,-81.68992127211789,-37.94674272386669,-36.52491988889552,-0.0176242699355293,3286141715.0,1
981,2014-01-22,2009.97,2052.34,2008.93,2051.75,98892856.0,43.440000000000055,0.0,43.440000000000055,56.95264008633978,1984.82,2102.17,57.03451214316148,-42.96548785683853,-33.240733629376564,-35.86808263699173,0.0119006519959361,3385034571.0,1
982,2014-01-23,2048.33,2052.53,2039.05,2042.18,84210585.0,-9.569999999999936,9.569999999999936,0.0,52.41893332634118,1984.82,2078.68,61.11229490730896,-38.88770509269104,-29.9382964911938,-34.682125407832146,0.0143446083544429,3300823986.0,0
983,2014-01-24,2037.67,2060.99,2034.45,2054.39,92947921.0,12.209999999999807,0.0,12.209999999999807,57.410056239610846,1984.82,2062.95,89.04390119032387,-10.956098809676128,-26.03572270496852,-32.95284486725942,0.0223083660104699,3393771907.0,1
984,2014-01-27,2044.27,2044.85,2029.63,2033.3,88815426.0,-21.08999999999992,21.08999999999992,0.0,47.48317805735464,1984.82,2062.95,62.05042877255868,-37.949571227441325,-24.36384041997735,-31.23504397780301,0.0031872274081821,3304956481.0,0
985,2014-01-28,2036.4,2047.13,2026.99,2038.51,72529043.0,5.210000000000036,0.0,5.210000000000036,49.95000026748904,1984.82,2060.99,70.48706839963262,-29.51293160036738,-22.360697998175738,-29.46017478187756,0.007492524773272,3377485524.0,1
986,2014-01-29,2042.18,2051.58,2039.77,2049.91,73865462.0,11.399999999999864,0.0,11.399999999999864,55.25624062770423,1984.82,2060.99,85.45359065248792,-14.546409347512078,-19.62705994122939,-27.493551813747928,0.0129515244354398,3451350986.0,1
987,2014-01-30,2045.93,2045.93,2031.47,2033.08,62615184.0,-16.829999999999927,16.829999999999927,0.0,46.803651688159135,1984.82,2060.99,63.35827753708821,-36.641722462911794,-18.60421462662771,-25.71568437632388,0.0140302750692036,3388735802.0,0
988,2014-02-07,2022.32,2044.73,2014.7,2044.5,73598755.0,11.420000000000073,0.0,11.420000000000073,52.49339068084078,1984.82,2060.99,78.35105684652774,-21.648943153472253,-16.679829099499557,-23.90851332095902,0.0267419962335215,3462334557.0,1
989,2014-02-10,2049.98,2087.98,2049.98,2086.07,124331833.0,41.57000000000016,0.0,41.57000000000016,67.2194977566815,1984.82,2087.98,98.14850717332314,-1.851492826676864,-11.66591076229679,-21.459992809226577,0.038719122047891,3586666390.0,1
990,2014-02-11,2086.18,2111.06,2082.52,2103.67,142211324.0,17.59999999999991,0.0,17.59999999999991,71.53063845818087,1984.82,2111.06,94.146070975919,-5.853929024081015,-6.200693708792187,-18.4081329891397,0.0253052272450347,3728877714.0,1
991,2014-02-12,2103.83,2110.9,2096.51,2109.96,126333186.0,6.289999999999964,0.0,6.289999999999964,72.9951866214021,1984.82,2111.06,99.12864385297851,-0.8713561470214742,-1.346398937997492,-14.995786178911256,0.0331900224270143,3855210900.0,1
992,2014-02-13,2106.93,2122.83,2096.97,2098.4,146532634.0,-11.559999999999944,11.559999999999944,0.0,65.81544451211997,1984.82,2122.83,82.2983841750599,-17.701615824940102,1.55000179624858,-11.686628583879289,0.0214224173598975,3708678266.0,0
993,2014-02-14,2097.32,2116.19,2095.09,2115.85,111517950.0,17.449999999999818,0.0,17.449999999999818,70.81527942981754,1992.02,2122.83,94.66401651249905,-5.335983487500972,5.193620584660948,-8.310578750171242,0.0405990262135445,3820196216.0,1
994,2014-02-17,2124.88,2136.45,2117.69,2135.42,140244443.0,19.570000000000164,0.0,19.570000000000164,75.45985608202187,2008.93,2136.45,99.1922835633628,-0.8077164366371921,9.550260711369448,-4.738410857863103,0.047539624529681,3960440659.0,1
995,2014-02-18,2134.14,2134.14,2113.13,2119.07,142869308.0,-16.34999999999991,16.34999999999991,0.0,65.42303623811698,2014.7,2136.45,85.72484599589349,-14.275154004106518,11.550474363789364,-1.4806338135326091,0.0337380665492632,3817571351.0,0
996,2014-02-19,2116.92,2152.96,2111.17,2142.55,151261246.0,23.480000000000015,0.0,23.480000000000015,71.66747816143948,2014.7,2152.96,92.47070736293948,-7.5292926370605056,14.859012417807662,1.7872954327354462,0.0538444134023257,3968832597.0,1
997,2014-02-20,2152.89,2177.98,2136.48,2138.78,157052276.0,-3.769999999999982,3.769999999999982,0.0,69.34726814352618,2014.7,2177.98,75.9921607055366,-24.00783929446339,16.981097646251328,4.826055875438624,0.0461139642944485,3811780321.0,0
998,2014-02-21,2131.59,2132.7,2098.33,2113.69,117662651.0,-25.090000000000146,25.090000000000146,0.0,55.53973241383511,2014.7,2177.98,60.62591866731996,-39.37408133268004,16.448701769434138,7.1505850542377285,0.0132402076632136,3694117670.0,0
999,2014-02-24,2099.72,2099.72,2058.79,2076.69,123555308.0,-37.0,37.0,0.0,41.48489603555226,2014.7,2177.98,37.96545810877022,-62.03454189122978,12.892565948344329,8.298981233059049,-0.0128252054742425,3570562362.0,0
1000,2014-02-25,2077.28,2087.62,2026.54,2034.22,140132978.0,-42.47000000000003,42.47000000000003,0.0,31.071135629812247,2014.7,2177.98,11.954924056834876,-88.04507594316513,6.571575593378384,7.953500105122916,-0.0358964150979165,3430429384.0,0
1001,2014-02-26,2026.61,2041.63,2014.38,2041.25,110112687.0,7.029999999999973,0.0,7.029999999999973,34.224697807259815,2014.38,2177.98,16.42420537897305,-83.57579462102696,2.1051406931242127,6.783828222723176,-0.0272350362180709,3540542071.0,1
1002,2014-02-27,2045.1,2068.31,2036.39,2047.35,132163852.0,6.099999999999909,0.0,6.099999999999909,37.10563904655292,2014.38,2177.98,20.15281173594121,-79.84718826405879,-0.931583410415442,5.240745896095452,-0.0323746957487535,3672705923.0,1
1003,2014-02-28,2040.62,2058.49,2020.94,2056.3,111637907.0,8.950000000000273,0.0,8.950000000000273,41.44733421036332,2014.38,2177.98,25.623471882640647,-74.37652811735936,-2.5862067575144465,3.675355365373472,-0.0370512592370586,3784343830.0,1
1004,2014-03-03,2052.07,2078.33,2047.07,2075.24,127460891.0,18.9399999999996,0.0,18.9399999999996,49.89328249933507,2014.38,2177.98,37.20048899755483,-62.799511002445165,-2.3422084481758247,2.4718426026636124,-0.0206836017687006,3911804721.0,1
1005,2014-03-04,2068.11,2074.02,2050.12,2071.47,115925792.0,-3.769999999999982,3.769999999999982,0.0,48.29336176685769,2014.38,2177.98,34.896088019559734,-65.10391198044026,-2.425090588174044,1.492455964496081,-0.0331754218104596,3795878929.0,0
1006,2014-03-05,2073.29,2074.81,2050.18,2053.08,107733082.0,-18.389999999999876,18.389999999999876,0.0,40.9097118778775,2014.38,2177.98,23.655256723716285,-76.34474327628372,-3.929398924773977,0.4080849866420692,-0.0400695723730352,3688145847.0,0
1007,2014-03-06,2050.03,2065.79,2030.95,2059.58,109290133.0,6.5,0.0,6.5,44.37795958397168,2014.38,2177.98,27.628361858190612,-72.37163814180938,-4.54469008393653,-0.582470027473651,-0.0255997804786889,3797435980.0,1
1008,2014-03-07,2058.38,2079.49,2050.47,2057.91,103709540.0,-1.6700000000000728,1.6700000000000728,0.0,43.61899643293177,2014.38,2177.98,26.60757946210255,-73.39242053789745,-5.10818384015829,-1.4876127900105791,-0.0090432370743829,3693726440.0,0
1009,2014-03-10,2042.35,2042.63,1995.55,1999.06,115696666.0,-58.84999999999991,58.84999999999991,0.0,25.727932909455063,1995.55,2177.98,1.9240256536753768,-98.07597434632464,-10.186041525629662,-3.2272985371343963,-0.0172842662052286,3578029774.0,0
1010,2014-03-11,1994.42,2008.07,1985.6,2001.16,92705265.0,2.1000000000001364,0.0,2.1000000000001364,26.96141702615208,1985.6,2177.98,8.088158852271631,-91.91184114772835,-13.88081844130511,-5.35800251796854,-0.0196399265156154,3670735039.0,1
1011,2014-03-12,1996.24,2011.06,1974.38,1997.69,101361719.0,-3.4700000000000277,3.4700000000000277,0.0,26.13391214525342,1974.38,2132.7,14.723345123799891,-85.27665487620011,-16.894209831747958,-7.665243980724425,-0.0242557452316408,3569373320.0,0
1012,2014-03-13,2000.69,2029.12,1996.53,2019.11,100978116.0,21.419999999999845,0.0,21.419999999999845,39.384857902592266,1974.38,2099.72,35.68693154619427,-64.31306845380573,-17.353884455807247,-9.602972075740992,-0.0180858824101542,3670351436.0,1
1013,2014-03-14,2008.82,2017.91,1990.98,2004.34,87775111.0,-14.769999999999982,14.769999999999982,0.0,34.46563008415333,1974.38,2087.62,26.457082303073005,-73.542917696927,-18.69449694524633,-11.42127704964206,-0.0341647231163624,3582576325.0,0
1014,2014-03-17,2009.88,2024.37,1999.25,2023.67,86250374.0,19.330000000000155,0.0,19.330000000000155,44.86474356273396,1974.38,2079.49,46.89373037769967,-53.10626962230034,-17.98979736352203,-12.734981112418057,-0.0230754005609541,3668826699.0,1
1015,2014-03-18,2026.22,2034.92,2020.41,2025.2,96777193.0,1.5299999999999727,0.0,1.5299999999999727,45.65236105746044,1974.38,2079.49,48.34934830177918,-51.65065169822082,-17.11061908879742,-13.61010870769393,-0.0135795974828062,3765603892.0,1
1016,2014-03-19,2019.98,2022.18,2002.44,2021.73,95180797.0,-3.4700000000000277,3.4700000000000277,0.0,44.00724665840798,1974.38,2079.49,45.04804490533732,-54.95195509466269,-16.503620507873165,-14.18881106772978,-0.0183775332834849,3670423095.0,0
1017,2014-03-20,2017.22,2030.85,1993.0,1993.48,110333048.0,-28.25,28.25,0.0,32.87782065271382,1974.38,2079.49,18.17143944439156,-81.82856055560845,-18.09353762529304,-14.969756379242432,-0.0313084634410638,3560090047.0,0
1018,2014-03-21,1987.68,2052.47,1986.07,2047.62,144477656.0,54.13999999999987,0.0,54.13999999999987,56.9519204495745,1974.38,2079.49,69.67938350299687,-30.32061649700313,-14.814144624692515,-14.93863402833245,0.024291416965974,3704567703.0,1
1019,2014-03-24,2050.83,2074.06,2043.33,2066.28,147700085.0,18.66000000000031,0.0,18.66000000000031,62.32559872600743,1974.38,2079.49,87.43221387118292,-12.56778612881707,-10.587450454709824,-14.068397313607925,0.0325411261468349,3852267788.0,1
1020,2014-03-25,2063.32,2079.55,2057.49,2067.31,131822232.0,1.0299999999997451,0.0,1.0299999999997451,62.62276433754728,1974.38,2079.55,88.36170010459234,-11.638299895407652,-7.07311798016849,-12.669341446920038,0.0348502520411073,3984090020.0,1
1021,2014-03-26,2070.57,2074.57,2057.65,2063.67,102611116.0,-3.6399999999998727,3.6399999999998727,0.0,60.67135685947683,1974.38,2079.55,84.90063706380138,-15.099362936198627,-4.529488628545778,-11.041370883245188,0.022069129467934,3881478904.0,0
1022,2014-03-27,2060.81,2073.98,2042.71,2046.59,119149374.0,-17.080000000000155,17.080000000000155,0.0,51.91293770279605,1974.38,2079.55,68.6602643339353,-31.33973566606469,-3.847505647889193,-9.60259783617399,0.021079258010118,3762329530.0,0
1023,2014-03-28,2046.85,2060.13,2035.24,2041.71,121681965.0,-4.879999999999882,4.879999999999882,0.0,49.554600719702265,1974.38,2079.55,64.02015783968801,-35.97984216031199,-3.65863002888068,-8.413804274715329,0.008914496928847,3640647565.0,0
1024,2014-03-31,2043.05,2048.13,2024.19,2033.31,94356536.0,-8.400000000000091,8.400000000000091,0.0,45.45346083651831,1974.38,2079.55,56.03308928401616,-43.96691071598384,-4.139042235880879,-7.558851866948438,0.0040045427612087,3546291029.0,0
1025,2014-04-01,2031.01,2050.68,2028.1,2047.46,83286576.0,14.150000000000093,0.0,14.150000000000093,53.011921355527264,1986.07,2079.55,65.67180145485659,-34.328198545143415,-3.339490064888196,-6.71497950653639,0.0127267241421951,3629577605.0,1
1026,2014-04-02,2049.42,2060.78,2046.74,2058.99,102658525.0,11.529999999999744,0.0,11.529999999999744,58.42803176396072,1986.07,2079.55,78.00599058622129,-21.99400941377872,-1.7552313546812002,-5.723029876165352,0.0328621305455785,3732236130.0,1
1027,2014-04-03,2063.5,2066.01,2037.45,2043.7,108618421.0,-15.289999999999736,15.289999999999736,0.0,49.66805318219959,1986.07,2079.55,61.64955070603333,-38.35044929396667,-1.713715483668011,-4.9211669976658845,-0.0019144177142242,3623617709.0,0
1028,2014-04-04,2037.55,2060.1,2035.22,2058.83,83189056.0,15.129999999999882,0.0,15.129999999999882,57.024702131516825,1986.07,2079.55,77.83483097988854,-22.16516902011147,-0.4547077159663786,-4.027875141325984,-0.0036055132895833,3706806765.0,1
1029,2014-04-08,2054.53,2102.45,2052.9,2098.28,133370983.0,39.45000000000027,0.0,39.45000000000027,70.15057638055883,1986.07,2102.45,96.4169101220144,-3.583089877985584,3.6838847825574703,-2.4855231565492923,0.014980820486526,3840177748.0,1
1030,2014-04-09,2100.65,2108.75,2095.64,2105.24,105340471.0,6.959999999999582,0.0,6.959999999999582,71.89784284177779,1986.07,2108.75,97.13889794587529,-2.861102054124728,7.439603865075242,-0.500497752224385,0.0201437245296001,3945518219.0,1
1031,2014-04-10,2105.88,2146.67,2098.08,2134.3,156789609.0,29.0600000000004,0.0,29.0600000000004,78.07953341321489,1986.07,2146.67,92.29763387297642,-7.702366127023587,12.615513643514532,2.1227045269233997,0.0428566542394912,4102307828.0,1
1032,2014-04-11,2130.37,2138.65,2120.18,2130.54,131768359.0,-3.7600000000002174,3.7600000000002174,0.0,75.59690477925332,2024.19,2146.67,86.83050293925531,-13.169497060744698,16.227004055185716,4.943564432575863,0.0435076480009404,3970539469.0,0
1033,2014-04-14,2127.41,2134.43,2116.61,2131.54,102077853.0,1.0,0.0,1.0,75.83271492006376,2024.19,2146.67,87.64696276943165,-12.353037230568344,18.951368291621293,7.745125204384951,0.0483103904471033,4072617322.0,1
1034,2014-04-15,2125.9,2125.9,2098.15,2101.6,107531151.0,-29.94000000000005,29.94000000000005,0.0,56.853623590076666,2024.19,2146.67,63.202155453951534,-36.79784454604847,18.481495618838835,9.89239928727573,0.0264425190235706,3965086171.0,0
1035,2014-04-16,2097.21,2112.05,2092.16,2105.12,89361657.0,3.519999999999982,0.0,3.519999999999982,58.27040154620191,2024.19,2146.67,66.0760940561723,-33.92390594382771,18.183544144506868,11.55062825872196,0.022404188461333,4054447828.0,1
1036,2014-04-17,2108.95,2110.72,2095.71,2098.89,89896325.0,-6.230000000000018,6.230000000000018,0.0,54.60846573177795,2024.19,2146.67,60.98954931417359,-39.01045068582641,17.245906446446043,12.689683896266777,0.02700494201693,3964551503.0,0
1037,2014-04-18,2091.48,2099.64,2081.19,2097.75,88155695.0,-1.139999999999873,1.139999999999873,0.0,53.89337230134839,2024.19,2146.67,60.05878510777264,-39.94121489222736,16.22381529900258,13.39651017681394,0.0189039405876152,3876395808.0,0
1038,2014-04-21,2085.98,2103.08,2065.23,2065.83,96378369.0,-31.920000000000076,31.920000000000076,0.0,37.87129280523605,2028.1,2146.67,31.820865311630232,-68.17913468836977,12.691820066117089,13.255572154674567,-0.0154650475627657,3780017439.0,0
1039,2014-04-22,2062.79,2073.66,2047.33,2072.83,98719882.0,7.0,0.0,7.0,42.217988554815214,2035.22,2146.67,33.74607447285768,-66.25392552714231,10.338355766094082,12.672128876958473,-0.0153949193441127,3878737321.0,1
1040,2014-04-23,2068.08,2076.35,2059.11,2066.36,72925682.0,-6.4699999999998,6.4699999999998,0.0,39.28664942955019,2035.22,2146.67,27.940780619111788,-72.05921938088822,7.860532103499281,11.709809522266635,-0.0318324509206765,3805811639.0,0
1041,2014-04-24,2064.16,2075.76,2056.19,2057.03,78185955.0,-9.329999999999927,9.329999999999927,0.0,35.21793100993733,2035.22,2146.67,19.56931359353985,-80.43068640646015,5.085365050429573,10.384920627899223,-0.0345029898523377,3727625684.0,0
1042,2014-04-25,2060.54,2065.64,2035.57,2036.52,93042333.0,-20.51000000000022,20.51000000000022,0.0,27.891179698951237,2035.57,2146.67,0.855085508550895,-99.14491449144911,1.2170106350567949,8.551338629330738,-0.0445780984640212,3634583351.0,0
1043,2014-04-28,2033.34,2035.99,2000.14,2003.49,89795262.0,-33.02999999999997,33.02999999999997,0.0,20.11510096535909,2000.14,2146.67,2.286221251620767,-97.71377874837924,-4.462492233227749,5.94857245681904,-0.0466834792539017,3544788089.0,0
1044,2014-04-29,2001.9,2021.68,1997.64,2020.34,76221275.0,16.84999999999991,0.0,16.84999999999991,31.376801178293505,1997.64,2146.67,15.231832516942776,-84.76816748305723,-7.517231036205885,3.2554117582140547,-0.0402732385802234,3621009364.0,1
1045,2014-04-30,2020.44,2029.54,2016.58,2026.36,74528578.0,6.019999999999982,0.0,6.019999999999982,35.14576612042168,1997.64,2138.65,20.36734983334501,-79.63265016665498,-9.344650542399904,0.7353992980912625,-0.0345563607430594,3695537942.0,1
1046,2014-05-05,2022.18,2028.96,2007.35,2027.35,79933395.0,0.9900000000000092,0.0,0.9900000000000092,35.81468495823911,1997.64,2134.43,21.71942393449804,-78.28057606550196,-10.590923368706854,-1.5298652352683615,-0.0335597664163985,3775471337.0,1
1047,2014-05-06,2024.26,2038.7,2021.48,2028.04,74609411.0,0.6900000000000546,0.0,0.6900000000000546,36.342698571930526,1997.64,2125.9,23.701855605800613,-76.29814439419938,-11.39161092927543,-3.5022143740697764,-0.0182928895407656,3850080748.0,1
1048,2014-05-07,2023.15,2024.63,2008.45,2010.08,74360192.0,-17.960000000000036,17.960000000000036,0.0,29.14254091421789,1997.64,2112.05,10.87317542172871,-89.1268245782713,-13.321817867849177,-5.466135072825657,-0.0302726224533608,3775720556.0,0
1049,2014-05-08,2006.85,2036.94,2005.69,2015.27,77865393.0,5.190000000000055,0.0,5.190000000000055,33.53328363720746,1997.64,2110.72,15.590732224973408,-84.40926777502659,-14.268255579063634,-7.226559174073253,-0.0247246365589733,3853585949.0,1
1050,2014-05-09,2016.5,2020.45,2001.3,2011.14,76224244.0,-4.129999999999882,4.129999999999882,0.0,31.72807760837634,1997.64,2103.08,12.803490136570584,-87.19650986342941,-15.176624092646987,-8.816572157788,-0.0223088627778885,3777361705.0,0
1051,2014-05-12,2022.93,2055.51,2016.64,2052.87,115742077.0,41.72999999999979,0.0,41.72999999999979,58.05414482163362,1997.64,2103.08,52.380500758725226,-47.61949924127477,-12.386466955509604,-9.530551117332324,0.0080284013906075,3893103782.0,1
1052,2014-05-13,2055.08,2061.06,2043.55,2050.73,97223388.0,-2.1399999999998727,2.1399999999998727,0.0,56.75907711332087,1997.64,2076.35,67.45013340109269,-32.54986659890732,-10.23000233860148,-9.670441361586157,0.0235788548982025,3795880394.0,0
1053,2014-05-14,2049.27,2056.57,2042.74,2047.91,72011125.0,-2.8199999999999363,2.8199999999999363,0.0,54.89702722851799,1997.64,2076.35,63.86736119933948,-36.13263880066052,-8.648840575057193,-9.466121204280364,0.0136462179633132,3723869269.0,0
1054,2014-05-15,2044.38,2047.32,2022.86,2024.97,75845154.0,-22.94000000000005,22.94000000000005,0.0,41.97253708165209,1997.64,2075.76,34.984639016896935,-65.01536098310306,-9.14144784777818,-9.401186532979926,-0.0006859590595944,3648024115.0,0
1055,2014-05-16,2023.6,2027.76,2012.69,2026.5,66353660.0,1.5299999999999727,0.0,1.5299999999999727,43.00517003207536,1997.64,2065.64,42.44117647058823,-57.558823529411775,-9.301166390818253,-9.381182504547592,-0.0004192665301995,3714377775.0,1
1056,2014-05-19,2023.01,2023.27,1996.02,2005.18,65329438.0,-21.319999999999936,21.319999999999936,0.0,33.437779496592114,1996.02,2061.06,14.0836408364085,-85.91635916359151,-11.021046544017054,-9.709155312441483,-0.0112719670223466,3649048337.0,0
1057,2014-05-20,2011.85,2018.16,2002.76,2008.12,61345382.0,2.939999999999827,0.0,2.939999999999827,35.713407534839405,1996.02,2061.06,18.603936039360264,-81.39606396063974,-12.008405107987072,-10.169005271550605,-0.0009750855687336,3710393719.0,1
1058,2014-05-21,2001.31,2025.19,1991.06,2024.95,61811547.0,16.830000000000155,0.0,16.830000000000155,47.55615997374128,1991.06,2061.06,48.41428571428586,-51.58571428571415,-11.30256460844248,-10.39571713892898,0.0048033266013982,3772205266.0,1
1059,2014-05-22,2023.15,2041.96,2018.88,2021.29,74728474.0,-3.660000000000082,3.660000000000082,0.0,45.45500155544176,1991.06,2061.06,43.18571428571431,-56.81428571428568,-10.912717326937129,-10.49911717653061,0.0050468888292212,3697476792.0,0
1060,2014-05-23,2020.11,2034.57,2017.74,2034.57,63488065.0,13.279999999999973,0.0,13.279999999999973,53.9695585123863,1991.06,2061.06,62.15714285714285,-37.84285714285716,-9.423546752231232,-10.284003091670735,-0.0089143491794414,3760964857.0,1
1061,2014-05-26,2042.03,2045.38,2035.09,2041.48,70281220.0,6.910000000000082,0.0,6.910000000000082,57.913893153472095,1991.06,2061.06,72.02857142857152,-27.97142857142847,-7.598201752080286,-9.746842823752646,-0.0045105889122409,3831246077.0,1
1062,2014-05-27,2039.79,2044.15,2032.84,2034.56,67577889.0,-6.920000000000073,6.920000000000073,0.0,52.69614172381846,1991.06,2061.06,62.142857142857146,-37.85714285714285,-6.633521746240149,-9.124178608250146,-0.006518841160012,3763668188.0,0
1063,2014-05-28,2034.56,2052.66,2029.34,2050.23,81338642.0,15.670000000000073,0.0,15.670000000000073,61.70976605700576,1991.06,2061.06,84.52857142857152,-15.471428571428469,-4.552094143416753,-8.209761715283467,0.0124742588779092,3845006830.0,1
1064,2014-05-29,2051.84,2057.08,2039.24,2040.59,81242921.0,-9.6400000000001,9.6400000000001,0.0,54.35754334821692,1991.06,2061.06,70.75714285714282,-29.242857142857183,-3.638473153815312,-7.295504002989835,0.0069528744140143,3763763909.0,0
1065,2014-05-30,2040.39,2046.96,2031.37,2039.21,75148898.0,-1.3799999999998818,1.3799999999998818,0.0,53.308457971821376,1991.06,2061.06,68.78571428571442,-31.214285714285584,-2.991294621748011,-6.434662126741471,0.0169710449934668,3688615011.0,0
1066,2014-06-03,2039.2,2049.58,2037.3,2038.31,71584124.0,-0.900000000000091,0.900000000000091,0.0,52.545331570024,1991.06,2057.08,71.56922144804606,-28.43077855195393,-2.5219519584845784,-5.652120093090093,0.015033962113818,3617030887.0,0
1067,2014-06-04,2037.99,2038.48,2012.91,2024.83,72412771.0,-13.480000000000018,13.480000000000018,0.0,42.12396078094253,1991.06,2057.08,51.15116631323839,-48.8488336867616,-3.200820789733825,-5.16186023241884,-5.926072248707559e-05,3544618116.0,0
1068,2014-06-05,2019.44,2041.7,2016.18,2040.88,67949536.0,16.050000000000182,0.0,16.050000000000182,54.51688879331246,1991.06,2057.08,75.46198121781306,-24.538018782186946,-2.41587960863626,-4.612664107662324,0.0096918304647033,3612567652.0,1
1069,2014-06-06,2040.86,2041.57,2022.16,2029.96,66021744.0,-10.920000000000073,10.920000000000073,0.0,46.67137749331391,1991.06,2057.08,58.92153892759785,-41.07846107240215,-2.6444769213528616,-4.219026670400432,-0.0022658350413108,3546545908.0,0
1070,2014-06-09,2024.94,2045.26,2023.2,2030.5,64788317.0,0.5399999999999636,0.0,0.5399999999999636,47.105705709630925,1991.06,2057.08,59.73947288700404,-40.260527112995966,-2.7503639678247964,-3.925294129885304,-0.0053784509277583,3611334225.0,1
1071,2014-06-10,2033.21,2052.76,2026.39,2052.53,79623717.0,22.0300000000002,0.0,22.0300000000002,61.76437424843732,1991.06,2057.08,93.10814904574411,-6.891850954255875,-1.0446018080197064,-3.349155665512185,0.0088323765335012,3690957942.0,1
1072,2014-06-11,2049.13,2056.63,2045.41,2054.95,74444354.0,2.419999999999618,0.0,2.419999999999618,63.06187991130707,2012.91,2057.08,95.1777224360423,-4.822277563957702,0.4967742637134051,-2.579969679667067,0.0023021807309422,3765402296.0,1
1073,2014-06-12,2051.58,2057.1,2045.96,2051.71,81711186.0,-3.2399999999997817,3.2399999999997817,0.0,59.9206815974304,2012.91,2057.1,87.80267028739559,-12.197329712604422,1.4402823055136196,-1.7759192826309294,0.0054494043389412,3683691110.0,0
1074,2014-06-13,2049.21,2073.6,2048.62,2070.72,97174806.0,19.009999999999764,0.0,19.009999999999764,70.02788222256108,2012.91,2073.6,95.25457241720196,-4.745427582798018,3.679551770678472,-0.6848250719690487,0.0154520623182505,3780865916.0,1
1075,2014-06-16,2070.7,2087.32,2069.44,2085.98,95939770.0,15.260000000000218,0.0,15.260000000000218,75.70309170961525,2012.91,2087.32,98.1991667786586,-1.800833221341411,6.609354892723104,0.7740109209693823,0.0233870216012284,3876805686.0,1
1076,2014-06-17,2080.48,2080.48,2064.67,2066.7,87800481.0,-19.2800000000002,19.2800000000002,0.0,59.32679328338782,2012.91,2087.32,72.28867087756979,-27.711329122430215,7.291458707513129,2.0775004782781323,0.0206782791641766,3789005205.0,0
1077,2014-06-18,2064.38,2066.91,2051.75,2055.52,87245350.0,-11.179999999999836,11.179999999999836,0.0,51.82561824355138,2012.91,2087.32,57.2638086278724,-42.7361913721276,6.850925129841471,3.0321854085908004,0.0071733761906627,3701759855.0,0
1078,2014-06-19,2054.62,2059.25,2017.65,2023.73,92914274.0,-31.789999999999964,31.789999999999964,0.0,36.63015825530868,2012.91,2087.32,14.5410563096357,-85.4589436903643,3.89175010312033,3.204098347496706,-0.0030690259906599,3608845581.0,0
1079,2014-06-20,2013.41,2027.15,2010.53,2026.67,67167246.0,2.9400000000000546,0.0,2.9400000000000546,38.55270470079981,2010.53,2087.32,21.018361765855005,-78.981638234145,1.763487616622342,2.915976201321834,-0.0018862349175079,3676012827.0,1
1080,2014-06-23,2026.23,2033.32,2022.92,2024.36,70485162.0,-2.310000000000173,2.310000000000173,0.0,37.520709179569856,2010.53,2087.32,18.01015757260046,-81.98984242739954,-0.1083247316778397,2.3111160147218994,-0.0137245253418952,3605527665.0,0
1081,2014-06-24,2023.7,2034.71,2021.75,2033.93,71214634.0,9.570000000000164,0.0,9.570000000000164,44.60854426672229,2010.53,2087.32,30.47271780179715,-69.52728219820284,-0.810191104486421,1.6868545908802353,-0.0102289593420763,3676742299.0,1
1082,2014-06-25,2030.43,2030.62,2018.36,2025.5,67539610.0,-8.430000000000064,8.430000000000064,0.0,39.996789656944784,2010.53,2087.32,19.49472587576506,-80.50527412423494,-2.023332096237027,0.9448172534567826,-0.0127747098761521,3609202689.0,0
1083,2014-06-26,2025.66,2040.75,2025.31,2038.68,80955778.0,13.180000000000064,0.0,13.180000000000064,49.42848650545615,2010.53,2087.32,36.658419064982446,-63.34158093501755,-1.899344758192683,0.3759848511268893,-0.015472878998609,3690158467.0,1
1084,2014-06-27,2031.91,2043.98,2025.07,2036.51,97592017.0,-2.1700000000000728,2.1700000000000728,0.0,47.995288538061246,2010.53,2087.32,33.83253027737981,-66.1674697226202,-1.9536641399736252,-0.0899449470932137,-0.0237154718645432,3592566450.0,0
1085,2014-06-30,2038.61,2052.34,2038.53,2048.33,96666598.0,11.819999999999936,0.0,11.819999999999936,56.0115703860401,2010.53,2087.32,49.22515952597976,-50.77484047402023,-1.0310520984630784,-0.2781663773671867,-0.0088885663134464,3689233048.0,1
1086,2014-07-01,2051.23,2052.64,2041.94,2050.38,98457409.0,2.050000000000182,0.0,2.050000000000182,57.32788219002895,2010.53,2087.32,51.89477796588102,-48.10522203411898,-0.1329252614000324,-0.2491181541737558,-0.0025005837938817,3787690457.0,1
1087,2014-07-02,2049.49,2060.59,2044.04,2059.42,109553911.0,9.039999999999964,0.0,9.039999999999964,62.96655514521325,2010.53,2087.32,63.667144159395725,-36.33285584060428,1.2933897848627112,0.0593834336335376,0.0176357518048355,3897244368.0,1
1088,2014-07-03,2051.63,2066.64,2048.08,2063.23,122926582.0,3.8099999999999454,0.0,3.8099999999999454,65.20261666604719,2010.53,2087.32,68.62872769891902,-31.37127230108098,2.70006522241988,0.5875197913908063,0.0180394440140723,4020170950.0,1
1089,2014-07-04,2062.36,2065.08,2054.22,2059.38,105008792.0,-3.849999999999909,3.849999999999909,0.0,60.91424735692389,2010.53,2080.48,69.83559685489651,-30.164403145103496,3.4642688817889398,1.1628696094704332,0.017299294591871,3915162158.0,0
1090,2014-07-07,2058.13,2064.04,2050.89,2059.93,97168754.0,0.5499999999997272,0.0,0.5499999999997272,61.33343895482193,2010.53,2066.91,87.61972330613686,-12.38027669386313,4.067399738767335,1.743775635329814,0.012783134129493,4012330912.0,1
1091,2014-07-08,2058.13,2064.43,2047.2,2064.02,95053393.0,4.0900000000001455,0.0,4.0900000000001455,64.59184987934734,2010.53,2066.64,95.33060060595278,-4.669399394047221,4.8198538319697946,2.3589912746578103,0.0190175265366576,4107384305.0,1
1092,2014-07-09,2061.64,2062.47,2037.6,2038.61,113305841.0,-25.41000000000008,25.41000000000008,0.0,40.26704627387399,2010.53,2066.64,50.04455533772942,-49.95544466227058,3.327447735966416,2.552682566919532,-3.4335942865060254e-05,3994078464.0,0
1093,2014-07-10,2036.54,2045.53,2034.96,2038.34,97943819.0,-0.2699999999999818,0.2699999999999818,0.0,40.08197978294345,2018.36,2066.64,41.38359569179791,-58.6164043082021,2.0987256067783164,2.4618911748912886,0.000898596127689,3896134645.0,0
1094,2014-07-11,2033.87,2051.74,2033.0,2046.96,105088083.0,8.620000000000118,0.0,8.620000000000118,48.75757189837216,2018.36,2066.64,59.23777961889013,-40.76222038110988,1.799769800642025,2.329466900041436,-0.0006688375408259,4001222728.0,1
1095,2014-07-14,2047.74,2067.34,2044.9,2066.65,115119740.0,19.69000000000005,0.0,19.69000000000005,62.91127145747701,2018.36,2067.34,98.5912617394854,-1.4087382605146,3.1157472197587595,2.486722963984901,0.0079351144665866,4116342468.0,1
1096,2014-07-15,2065.9,2070.36,2059.68,2070.36,124488768.0,3.710000000000037,0.0,3.710000000000037,65.01229915149128,2025.07,2070.36,100.0,-0.0,4.407230984369107,2.870824568061743,0.0053121752726497,4240831236.0,1
1097,2014-07-16,2068.34,2075.49,2061.57,2067.28,137128020.0,-3.0799999999999272,3.0799999999999272,0.0,61.66603244566812,2025.07,2075.49,83.71677905593097,-16.283220944069036,5.123154378472464,3.321290530143888,0.0019629416012758,4103703216.0,0
1098,2014-07-17,2062.89,2062.89,2046.19,2055.59,104491812.0,-11.690000000000056,11.690000000000056,0.0,50.32269993863488,2033.0,2075.49,53.16545069428162,-46.834549305718376,4.693143882360346,3.5956612005871804,-0.0018403597199156,3999211404.0,0
1099,2014-07-18,2047.5,2067.23,2046.0,2059.07,106641094.0,3.480000000000018,0.0,3.480000000000018,53.27497512570976,2033.0,2075.49,61.35561308543257,-38.64438691456744,4.580364788455881,3.792601918160921,-0.0004174899147056,4105852498.0,1
1100,2014-07-21,2057.77,2061.82,2049.18,2054.48,93857870.0,-4.5900000000001455,4.5900000000001455,0.0,48.85621880213939,2033.0,2075.49,50.55307131089698,-49.44692868910302,4.07365336401881,3.848812207332499,-0.0046220482359666,4011994628.0,0
1101,2014-07-22,2050.5,2078.08,2049.81,2075.48,123191868.0,21.0,0.0,21.0,64.4305264771521,2033.0,2078.08,94.23247559893542,-5.767524401064581,5.305447508815632,4.1401392676291255,0.0180858526152625,4135186496.0,1
1102,2014-07-23,2074.2,2088.19,2072.23,2078.49,137292211.0,3.0099999999997635,0.0,3.0099999999997635,66.1360160699214,2033.0,2088.19,82.42435223772375,-17.57564776227625,6.450181411334143,4.602147696370129,0.0196974008261623,4272478707.0,1
1103,2014-07-24,2079.63,2107.95,2079.63,2105.06,165676996.0,26.570000000000164,0.0,26.570000000000164,77.24752858070235,2033.0,2107.95,96.14409606404286,-3.855903935957144,9.39309052115459,5.560336261327022,0.028383554148591,4438155703.0,1
1104,2014-07-25,2108.71,2127.22,2106.71,2126.61,142495826.0,21.550000000000185,0.0,21.550000000000185,82.59278035498468,2033.0,2127.22,99.35257907026144,-0.6474209297385628,13.310833094134978,7.110435627888614,0.0290131372027193,4580651529.0,1
1105,2014-07-28,2135.25,2181.5,2135.25,2177.95,236185752.0,51.33999999999969,0.0,51.33999999999969,89.42322858393807,2033.0,2181.5,97.60942760942748,-2.390572390572513,20.32409769582455,9.753168041475805,0.05196680770494,4816837281.0,1
1106,2014-07-29,2179.83,2193.52,2172.1,2183.19,200264257.0,5.2400000000002365,0.0,5.2400000000002365,89.89040085750248,2033.0,2193.52,93.5646648392724,-6.43533516072759,26.005212723407112,13.003576977862066,0.0560688440849812,5017101538.0,1
1107,2014-07-30,2178.18,2194.57,2177.24,2181.24,184922187.0,-1.9500000000002728,1.9500000000002728,0.0,88.21727424518795,2033.0,2194.57,91.74970600977882,-8.250293990221184,30.00431751455108,16.40372508519987,0.0611260027534672,4832179351.0,0
1108,2014-07-31,2179.54,2202.13,2173.9,2201.56,164691654.0,20.320000000000164,0.0,20.320000000000164,90.3719860855583,2044.9,2202.13,99.63747376454864,-0.3625262354513539,34.41655839063742,20.00629174628738,0.0692011442058793,4996871005.0,1
1109,2014-08-01,2194.17,2218.79,2184.64,2185.3,191475042.0,-16.259999999999764,16.259999999999764,0.0,77.31734064708628,2046.0,2218.79,80.61809132472956,-19.38190867527044,36.18413675918782,23.241860748867477,0.0636754799267942,4805395963.0,0
1110,2014-08-04,2190.04,2224.07,2186.92,2223.33,174097403.0,38.02999999999975,0.0,38.02999999999975,83.67964611524701,2046.0,2224.07,99.58443308811128,-0.4155669118887155,40.190368965212656,26.631562392136512,0.0712365332356852,4979493366.0,1
1111,2014-08-05,2224.63,2226.84,2206.85,2219.95,175386987.0,-3.380000000000109,3.380000000000109,0.0,81.33993285059088,2046.0,2226.84,96.19000221189984,-3.809997788100156,42.60151534924671,29.82555298355856,0.0680590236181073,4804106379.0,0
1112,2014-08-06,2212.0,2223.89,2192.99,2217.47,177711707.0,-2.480000000000018,2.480000000000018,0.0,79.45901906720013,2046.0,2226.84,94.81862419818606,-5.181375801813945,43.8072680393102,32.621895994708886,0.0533999030906482,4626394672.0,0
1113,2014-08-07,2216.66,2220.57,2185.76,2187.67,175233274.0,-29.799999999999727,29.799999999999727,0.0,60.168404465625954,2049.18,2226.84,77.9522683778003,-22.04773162219971,41.875509969823725,34.472618789731854,0.0287123638090669,4451161398.0,0
1114,2014-08-08,2188.71,2199.58,2180.6,2194.43,135181443.0,6.759999999999764,0.0,6.759999999999764,62.54827344225904,2049.81,2226.84,81.69236852510858,-18.307631474891416,40.42406977327664,35.66290898644081,0.0075667485479464,4586342841.0,1
1115,2014-08-11,2199.43,2225.96,2198.31,2224.65,150583421.0,30.22000000000025,0.0,30.22000000000025,71.37137852355372,2072.23,2226.84,98.58353275984732,-1.4164672401526763,41.23694061902143,36.777715312956936,0.0189905596855977,4736926262.0,1
1116,2014-08-12,2222.7,2222.98,2210.0,2221.59,154799046.0,-3.059999999999945,3.059999999999945,0.0,69.45951782704091,2079.63,2226.84,96.4336661911555,-3.5663338088445067,41.15976603242234,37.65412545685002,0.018498652142818,4582127216.0,0
1117,2014-08-13,2223.05,2230.99,2202.44,2222.88,178062806.0,1.2899999999999636,0.0,1.2899999999999636,69.85234532660647,2106.71,2230.99,93.47441261667228,-6.525587383327719,40.733150432865386,38.269930452053096,0.0096840422246045,4760190022.0,1
1118,2014-08-14,2221.54,2230.89,2204.38,2206.47,170149123.0,-16.41000000000031,16.41000000000031,0.0,58.75890042257651,2135.25,2230.99,74.38897012742841,-25.61102987257159,38.62565216617168,38.34107479487682,0.0096874570997116,4590040899.0,0
1119,2014-08-15,2207.23,2230.87,2203.24,2226.73,149978691.0,20.26000000000022,0.0,20.26000000000022,66.36776613554986,2172.1,2230.99,92.76617422312825,-7.233825776871748,38.15048227441821,38.3029562907851,0.0015292376750191,4740019590.0,1
1120,2014-08-18,2229.8,2242.03,2228.13,2239.47,163928626.0,12.739999999999782,0.0,12.739999999999782,70.3384186169554,2173.9,2242.03,96.24247761632115,-3.757522383678844,38.35973113672617,38.31431125997332,0.0087929908331267,4903948216.0,1
1121,2014-08-19,2242.34,2246.02,2227.93,2245.33,177744592.0,5.860000000000127,0.0,5.860000000000127,72.08739001155047,2173.9,2246.02,99.04326123128112,-0.9567387687188792,38.553989007346445,38.362246809447946,0.0125638678313573,5081692808.0,1
1122,2014-08-20,2241.66,2248.94,2233.89,2240.21,167658383.0,-5.119999999999891,5.119999999999891,0.0,68.04265646187999,2180.6,2248.94,87.22563652326602,-12.774363476733978,37.85839059820455,38.26147556719927,0.0240164192954146,4914034425.0,0
1123,2014-08-21,2239.57,2240.08,2211.63,2230.46,165733498.0,-9.75,9.75,0.0,60.57465910156487,2180.6,2248.94,72.95873573309925,-27.04126426690076,36.1041936611482,37.83001918598906,0.0164188422506073,4748300927.0,0
1124,2014-08-22,2228.97,2243.3,2225.27,2240.81,160111672.0,10.349999999999907,0.0,10.349999999999907,65.24666158891378,2180.6,2248.94,88.10359964881461,-11.896400351185385,35.14402006475166,37.29281936174158,0.0072640640100689,4908412599.0,1
1125,2014-08-25,2241.1,2241.55,2222.01,2229.27,162119578.0,-11.539999999999964,11.539999999999964,0.0,56.61537801449258,2180.6,2248.94,71.21744220076086,-28.782557799239143,33.070675850313364,36.44839065945594,0.003456983511809,4746293021.0,0
1126,2014-08-26,2225.29,2232.78,2200.62,2207.11,163507424.0,-22.15999999999985,22.15999999999985,0.0,43.782375824254494,2180.6,2248.94,38.79133743049482,-61.20866256950518,29.301637780877627,35.01904008374028,-0.0070944000575829,4582785597.0,0
1127,2014-08-27,2207.03,2216.67,2204.05,2209.47,120885885.0,2.3599999999996726,0.0,2.3599999999996726,45.30581515871694,2180.6,2248.94,42.24465905765266,-57.75534094234733,26.203028036665277,33.25583767432528,0.001359637792492,4703671482.0,1
1128,2014-08-28,2210.48,2219.47,2194.86,2195.82,124229014.0,-13.649999999999636,13.649999999999636,0.0,38.3670844893722,2194.86,2248.94,1.7751479289941523,-98.22485207100586,22.387843444628743,31.08223882838597,-0.0138813416983647,4579442468.0,0
1129,2014-08-29,2198.95,2218.7,2193.26,2217.2,105202496.0,21.37999999999965,0.0,21.37999999999965,51.72819548784931,2193.26,2248.94,42.99568965517182,-57.00431034482818,20.8491336537777,29.03561779346432,-0.0099443171821904,4684644964.0,1
1130,2014-09-01,2220.13,2236.29,2217.69,2235.51,129166583.0,18.3100000000004,0.0,18.3100000000004,60.2445718335938,2193.26,2248.94,75.88002873563241,-24.119971264367592,20.86662161076083,27.401818556923622,-0.0043735219321879,4813811547.0,1
1131,2014-09-02,2239.68,2267.51,2234.38,2266.05,192124869.0,30.539999999999964,0.0,30.539999999999964,70.32156392821973,2193.26,2267.51,98.03367003366998,-1.9663299663300156,23.078766060125872,26.53720805756408,0.0115346329138785,5005936416.0,1
1132,2014-09-03,2268.4,2290.55,2268.1,2288.63,212478998.0,22.579999999999927,0.0,22.579999999999927,75.59822013475531,2193.26,2290.55,98.02651865556577,-1.9734813444342412,26.35017534598046,26.49980151524736,0.0260798220994773,5218415414.0,1
1133,2014-09-04,2290.03,2307.7,2283.28,2306.86,199489978.0,18.230000000000015,0.0,18.230000000000015,79.0655145228997,2193.26,2307.7,99.2659909122687,-0.7340090877312948,30.06720341500068,27.21328189519803,0.0294759484293627,5417905392.0,1
1134,2014-09-05,2311.3,2327.56,2307.45,2326.43,213181917.0,19.56999999999971,0.0,19.56999999999971,82.19861957507786,2193.26,2327.56,99.15860014892024,-0.8413998510797555,34.19789830195396,28.61020517654922,0.0435837740605669,5631087309.0,1
1135,2014-09-09,2328.43,2331.92,2315.89,2326.53,196990318.0,0.1000000000003638,0.0,0.1000000000003638,82.21431381804634,2193.26,2331.92,96.11279388432143,-3.887206115678551,37.05245528401747,30.29865519804287,0.0541069543430097,5828077627.0,1
1136,2014-09-10,2318.5,2321.91,2306.42,2318.3,189828991.0,-8.230000000000018,8.230000000000018,0.0,75.86298821237006,2193.26,2331.92,90.17741237559504,-9.822587624404951,38.21015713282486,31.88095558499927,0.0492561564538103,5638248636.0,0
1137,2014-09-11,2315.73,2343.59,2304.6,2311.68,222221798.0,-6.620000000000346,6.620000000000346,0.0,70.78748087852856,2193.26,2343.59,78.77336526308765,-21.22663473691234,38.15365394163018,33.135495256325456,0.052763887750362,5416026838.0,0
1138,2014-09-12,2308.35,2331.95,2302.77,2331.95,193471540.0,20.269999999999985,0.0,20.269999999999985,76.37235737563006,2193.26,2343.59,92.25703452404689,-7.742965475953126,39.29156564150208,34.36670933336078,0.0517544650911059,5609498378.0,1
1139,2014-09-15,2330.19,2340.45,2321.59,2339.14,215112414.0,7.190000000000055,0.0,7.190000000000055,78.08698475125976,2193.26,2343.59,97.03984567285288,-2.9601543271471265,40.308886025829,35.55514467185443,0.0463563124298256,5824610792.0,1
1140,2014-09-16,2341.03,2347.94,2293.87,2296.55,302694111.0,-42.58999999999969,42.58999999999969,0.0,52.19740786599517,2193.26,2347.94,66.77657098525994,-33.22342901474006,37.24907850898171,35.89393143927989,0.0134595441406852,5521916681.0,0
1141,2014-09-17,2298.98,2309.05,2282.79,2307.89,210842453.0,11.33999999999969,0.0,11.33999999999969,56.61641827905005,2193.26,2347.94,74.10783553141957,-25.892164468580443,35.33191787887063,35.78152872719804,0.0084155149587306,5732759134.0,1
1142,2014-09-18,2303.85,2319.88,2297.93,2315.93,189089045.0,8.039999999999964,0.0,8.039999999999964,59.6666234931846,2193.26,2347.94,79.30566330488735,-20.694336695112654,34.06859353472282,35.438941688703,0.0039317513849994,5921848179.0,1
1143,2014-09-19,2312.98,2331.56,2305.52,2329.45,174648487.0,13.519999999999982,0.0,13.519999999999982,64.50833175955736,2217.69,2347.94,85.80422264875222,-14.195777351247784,33.76908194275802,35.104969739514004,0.0012981263137081,6096496666.0,1
1144,2014-09-22,2323.55,2323.55,2284.38,2289.87,175842354.0,-39.57999999999993,39.57999999999993,0.0,45.89736920784703,2234.38,2347.94,48.864036632616944,-51.135963367383056,29.99221010355177,34.08241781232156,-0.0157573725677298,5920654312.0,0
1145,2014-09-23,2289.09,2311.52,2289.02,2309.72,156855169.0,19.84999999999991,0.0,19.84999999999991,53.63756413486644,2268.1,2347.94,52.12925851703384,-47.87074148296616,28.274806695585998,32.920895588974446,-0.0037009877927793,6077509481.0,1
1146,2014-09-24,2302.23,2345.75,2297.88,2343.57,222525725.0,33.850000000000364,0.0,33.850000000000364,63.821765038049136,2282.79,2347.94,93.29240214888736,-6.70759785111264,29.307327595948664,32.19818199036929,0.013795161960133,6300035206.0,1
1147,2014-09-25,2352.86,2365.15,2336.8,2345.1,225688323.0,1.5299999999997451,0.0,1.5299999999997451,64.23153645565083,2282.79,2365.15,75.65565808644955,-24.344341913550448,29.90434736009638,31.73941506431471,0.0056390574411973,6525723529.0,1
1148,2014-09-26,2339.29,2350.11,2329.96,2347.72,174748285.0,2.619999999999891,0.0,2.619999999999891,65.01449752814733,2282.79,2365.15,78.8368139873722,-21.16318601262781,30.2403104532591,31.43959414210359,0.0036680147404601,6700471814.0,1
1149,2014-09-29,2353.71,2363.06,2346.58,2357.71,200111021.0,9.990000000000236,0.0,9.990000000000236,68.08782213102128,2282.79,2365.15,90.96648858669252,-9.033511413307483,30.955833555272875,31.34284202473745,0.0266312512246629,6900582835.0,1
1150,2014-09-30,2361.32,2365.49,2354.27,2363.87,193918690.0,6.159999999999855,0.0,6.159999999999855,69.96502301907793,2282.79,2365.49,98.0411124546555,-1.958887545344492,31.655051557645493,31.405283931319055,0.0242559220760087,7094501525.0,1
1151,2014-10-08,2368.58,2382.79,2354.29,2382.79,204397326.0,18.920000000000076,0.0,18.920000000000076,75.14626916002604,2282.79,2382.79,100.0,-0.0,33.35141835086961,31.79451081522917,0.0288696117758309,7298898851.0,1
1152,2014-10-09,2383.86,2391.35,2367.11,2389.37,235920010.0,6.579999999999927,0.0,6.579999999999927,76.75536641477674,2282.79,2391.35,98.17612380250551,-1.8238761974944908,34.82530779455419,32.40067021109418,0.0257228101053896,7534818861.0,1
1153,2014-10-10,2380.75,2386.28,2365.07,2374.54,224671126.0,-14.829999999999927,14.829999999999927,0.0,65.69463663931818,2282.79,2391.35,84.5154753131909,-15.484524686809095,34.400174933684866,32.80057115561232,0.036975898195094,7310147735.0,0
1154,2014-10-13,2366.43,2366.86,2341.12,2366.01,200899314.0,-8.529999999999745,8.529999999999745,0.0,59.96016222933055,2282.79,2391.35,76.65806927044979,-23.341930729550207,32.99461300640951,32.839379525771754,0.0243709194188042,7109248421.0,0
1155,2014-10-14,2362.8,2380.51,2349.19,2359.48,196831418.0,-6.5300000000002,6.5300000000002,0.0,55.66795181756446,2284.38,2391.35,70.20659998130321,-29.793400018696783,30.99647060747384,32.47079774211217,0.0067887880455885,6912417003.0,0
1156,2014-10-15,2358.23,2374.81,2344.37,2373.67,202804915.0,14.190000000000056,0.0,14.190000000000056,62.4141579857784,2284.38,2391.35,83.4720014957466,-16.527998504253407,30.2097041056586,32.018579014821455,0.0121828493454436,7115221918.0,1
1157,2014-10-16,2361.13,2389.68,2353.41,2356.5,248201168.0,-17.170000000000073,17.170000000000073,0.0,51.47728325260116,2284.38,2391.35,67.42077217911566,-32.57922782088434,27.87933486229167,31.1907301843155,0.0037397986131226,6867020750.0,0
1158,2014-10-17,2352.78,2360.6,2312.83,2341.18,212300962.0,-15.320000000000164,15.320000000000164,0.0,43.60988031454294,2289.02,2391.35,50.9723443760382,-49.0276556239618,24.513725513644204,29.85532925018124,-0.0070110403739221,6654719788.0,0
1159,2014-10-20,2346.05,2357.51,2340.46,2356.73,160022305.0,15.550000000000182,0.0,15.550000000000182,52.170933823030936,2297.88,2391.35,62.96137798224033,-37.03862201775967,22.83794923748337,28.451853247641665,-0.0030204706688607,6814742093.0,1
1160,2014-10-21,2355.03,2361.65,2337.55,2339.66,168828288.0,-17.070000000000164,17.070000000000164,0.0,43.75661526462878,2312.83,2391.35,34.16963830871107,-65.83036169128893,19.903048175106505,26.74209223313463,-0.0181006299338171,6645913805.0,0
1161,2014-10-22,2339.22,2352.12,2324.59,2326.55,152698425.0,-13.109999999999673,13.109999999999673,0.0,38.284773840580215,2312.83,2391.35,17.47325522159992,-82.52674477840007,16.330996936206702,24.659873173749045,-0.0262914492104612,6493215380.0,0
1162,2014-10-23,2322.32,2329.93,2297.33,2302.42,162636308.0,-24.13000000000011,24.13000000000011,0.0,30.250817971205777,2297.33,2391.35,5.413741757073119,-94.58625824292687,11.421372781100215,22.01217309521928,-0.0303721984047435,6330579072.0,0
1163,2014-10-24,2303.08,2314.88,2296.66,2302.28,132225281.0,-0.1399999999998726,0.1399999999998726,0.0,30.20838050757135,2296.66,2391.35,5.935156827542869,-94.06484317245712,7.433474964067045,19.096433468988835,-0.0269356427064973,6198353791.0,0
1164,2014-10-27,2293.57,2293.64,2279.84,2290.44,130261568.0,-11.840000000000146,11.840000000000146,0.0,26.57097764219816,2279.84,2391.35,9.505873912653511,-90.49412608734649,3.279840207541838,15.933114816699437,-0.0292606845576143,6068092223.0,0
1165,2014-10-28,2294.01,2338.28,2294.01,2337.87,178590357.0,47.42999999999984,0.0,47.42999999999984,52.82613984939588,2279.84,2391.35,52.04017576898921,-47.95982423101079,3.7717806096079594,13.50084797528114,-0.0150821302034402,6246682580.0,1
1166,2014-10-29,2343.72,2381.64,2339.71,2373.03,265588687.0,35.16000000000031,0.0,35.16000000000031,63.87462959611721,2279.84,2389.68,84.84158776402069,-15.158412235979318,6.919007071516262,12.184479794528164,0.007014640356461,6512271267.0,1
1167,2014-10-30,2371.89,2397.26,2365.92,2391.08,294645943.0,18.049999999999727,0.0,18.049999999999727,68.2758021684403,2279.84,2397.26,94.73684210526292,-5.263157894737087,10.745819745985957,11.896747784819723,0.0213140382200429,6806917210.0,1
1168,2014-10-31,2393.18,2423.6,2384.48,2420.18,325763522.0,29.09999999999991,0.0,29.09999999999991,74.1371353109775,2279.84,2423.6,97.62103505843066,-2.378964941569337,15.942942841413696,12.70598679613852,0.0269228974044544,7132680732.0,1
1169,2014-11-03,2425.23,2436.78,2418.17,2430.03,298821235.0,9.850000000000364,0.0,9.850000000000364,75.87779513874484,2279.84,2436.78,95.69899324582644,-4.301006754173568,20.61883195787232,14.288555828485284,0.0386252703384253,7431501967.0,1
1170,2014-11-04,2428.27,2435.22,2417.22,2430.68,309013039.0,0.6499999999996362,0.0,0.6499999999996362,76.00078219282513,2279.84,2436.78,96.11316426659847,-3.88683573340153,24.09915725472274,16.250676113732776,0.0447572586017921,7740515006.0,1
1171,2014-11-05,2432.17,2434.36,2415.5,2419.25,263606654.0,-11.429999999999836,11.429999999999836,0.0,68.87571003427156,2279.84,2436.78,88.83012616286466,-11.169873837135334,25.63947870091897,18.12843663117001,0.0507422624890332,7476908352.0,0
1172,2014-11-06,2419.62,2426.89,2401.75,2425.86,222005088.0,6.610000000000127,0.0,6.610000000000127,70.70811579895856,2279.84,2436.78,93.04192685102582,-6.958073148974174,27.081388908612556,19.919027086658524,0.0536772243167642,7698913440.0,1
1173,2014-11-07,2427.9,2454.42,2407.44,2418.17,291172245.0,-7.690000000000055,7.690000000000055,0.0,65.52929946684449,2279.84,2454.42,79.23588039867109,-20.76411960132891,27.289023528217516,21.39302637497032,0.0557665776008102,7407741195.0,0
1174,2014-11-10,2436.63,2474.16,2428.19,2473.67,300628203.0,55.5,0.0,55.5,78.58861761345028,2279.84,2474.16,99.74783861671482,-0.2521613832851906,31.56806462872601,23.428034025721463,0.0580870621548674,7708369398.0,1
1175,2014-11-11,2483.65,2508.62,2445.96,2469.67,411904065.0,-4.0,4.0,0.0,76.18827385838824,2279.84,2508.62,82.9749103942653,-17.025089605734706,34.24175136412441,25.59077749340205,0.0407243060559705,7296465333.0,0
1176,2014-11-12,2454.6,2494.92,2444.81,2494.48,252933852.0,24.809999999999945,0.0,24.809999999999945,80.45959344585694,2279.84,2508.62,93.81938980680134,-6.180610193198658,37.92544608429034,28.057711211579715,0.0432440570788095,7549399185.0,1
1177,2014-11-13,2495.0,2507.74,2471.41,2485.61,295037058.0,-8.86999999999989,8.86999999999989,0.0,74.91600999700412,2279.84,2508.62,89.94230264883302,-10.057697351166969,39.67175452790434,30.38051987484464,0.027035179201547,7254362127.0,0
1178,2014-11-14,2477.97,2481.02,2457.04,2478.82,220607619.0,-6.789999999999964,6.789999999999964,0.0,70.61842155541146,2294.01,2508.62,86.11434695494162,-13.88565304505837,40.0461927156025,32.31365444299622,0.0200779414245915,7033754508.0,0
1179,2014-11-17,2506.86,2508.77,2472.45,2474.01,215687800.0,-4.809999999999945,4.809999999999945,0.0,67.45548373772036,2339.71,2508.77,79.43925233644873,-20.56074766355127,39.4994853958151,33.75082063356,0.0178262872940906,6818066708.0,0
1180,2014-11-18,2474.18,2477.05,2449.81,2456.37,201062570.0,-17.640000000000327,17.640000000000327,0.0,56.70775881497745,2365.92,2508.77,63.318165908295335,-36.68183409170467,37.2138373772259,34.443423982293176,0.0153435982225895,6617004138.0,0
1181,2014-11-19,2452.15,2461.49,2442.71,2450.99,186235771.0,-5.380000000000109,5.380000000000109,0.0,53.69696757577708,2384.48,2508.77,53.5119478638666,-46.48805213613341,34.56982440109823,34.46870406605419,0.0103592128152489,6430768367.0,0
1182,2014-11-20,2443.28,2458.32,2437.48,2452.66,165495213.0,1.6700000000000728,0.0,1.6700000000000728,54.56103707061855,2401.75,2508.77,47.57054756120338,-52.429452438796616,32.237565523492776,34.022476357541905,0.0142628516605531,6596263580.0,1
1183,2014-11-21,2452.64,2488.2,2446.65,2486.79,212239774.0,34.13000000000011,0.0,34.13000000000011,68.44636986719709,2401.75,2508.77,79.46178284432814,-20.538217155671852,32.765538590627784,33.77108880415908,0.0053038602562185,6808503354.0,1
1184,2014-11-24,2505.53,2546.75,2495.52,2532.88,363485835.0,46.09000000000015,0.0,46.09000000000015,78.62441255268793,2401.75,2546.75,90.43448275862076,-9.565517241379236,36.4824914085757,34.3133693250424,0.025594512627193,7171989189.0,1
1185,2014-11-25,2532.0,2568.38,2527.08,2567.6,314315572.0,34.7199999999998,0.0,34.7199999999998,83.30518445063989,2401.75,2568.38,99.5318970173437,-0.4681029826563042,41.74856565159962,35.80040859035385,0.0293127224912606,7486304761.0,1
1186,2014-11-26,2572.65,2605.07,2570.4,2604.34,337127249.0,36.74000000000024,0.0,36.74000000000024,86.82715898398554,2407.44,2605.07,99.63062288114152,-0.3693771188584819,48.32946637588793,38.30622014746066,0.0477669465443091,7823432010.0,1
1187,2014-11-27,2615.37,2631.4,2599.11,2630.49,364075719.0,26.14999999999964,0.0,26.14999999999964,88.77239445596256,2428.19,2631.4,99.5521873923526,-0.4478126076474136,55.02071946328306,41.64912001062515,0.0611863709345574,8187507729.0,1
1188,2014-11-28,2629.63,2683.18,2622.06,2682.83,465880035.0,52.34000000000015,0.0,52.34000000000015,91.62767477713172,2437.48,2683.18,99.8575498575499,-0.1424501424501055,63.81140812761487,46.0815776340231,0.0844054793634623,8653387764.0,1
1189,2014-12-01,2691.73,2720.74,2668.84,2680.16,446791741.0,-2.6700000000000728,2.6700000000000728,0.0,90.27634599176316,2437.48,2720.74,85.67393913718846,-14.326060862811538,69.75851282898475,50.81696467301544,0.0911059815907213,8206596023.0,0
1190,2014-12-02,2667.82,2777.37,2665.69,2763.54,437733381.0,83.38000000000011,0.0,83.38000000000011,93.65053817466035,2437.48,2777.37,95.93103651181266,-4.068963488187335,80.27435254853117,56.70844224811859,0.1275199001219915,8644329404.0,1
1191,2014-12-03,2768.68,2824.18,2733.87,2779.52,562120281.0,15.980000000000018,0.0,15.980000000000018,94.10305060110736,2437.48,2824.18,88.45099560382728,-11.54900439617271,88.87320871001566,63.141395540498,0.1332675544103136,9206449685.0,1
1192,2014-12-04,2783.47,2900.51,2772.43,2899.46,532687718.0,119.94000000000004,0.0,119.94000000000004,96.3536145078177,2437.48,2900.51,99.77323283588532,-0.2267671641146754,104.16526742673432,71.34616991774527,0.1659448526011444,9739137403.0,1
1193,2014-12-05,2926.57,2978.03,2813.05,2937.65,640500296.0,38.190000000000055,0.0,38.190000000000055,96.802022072875,2437.48,2978.03,92.52983072796223,-7.470169272037756,118.00565226260504,80.67806638671723,0.1598062284829917,10379637699.0,1
1194,2014-12-08,2907.81,3041.66,2879.85,3020.26,587570890.0,82.61000000000013,0.0,82.61000000000013,97.5530635365181,2437.48,3041.66,96.4580092025556,-3.541990797444411,134.09443636748802,91.3613403828714,0.176296930986135,10967208589.0,1
1195,2014-12-09,2992.49,3091.32,2834.59,2856.27,771998379.0,-163.99000000000024,163.99000000000024,0.0,63.43164503672159,2437.48,3091.32,64.05083812553528,-35.94916187446472,132.0896440124252,99.50700110878218,0.0967346813396099,10195210210.0,0
1196,2014-12-10,2855.94,2946.71,2807.68,2940.01,512886913.0,83.74000000000024,0.0,83.74000000000024,69.68015705835089,2446.65,3091.32,76.52907689205331,-23.47092310794669,135.69375662298853,106.74435221162348,0.1176662903109309,10708097123.0,1
1197,2014-12-11,2912.35,2965.68,2892.61,2925.74,482632733.0,-14.270000000000437,14.270000000000437,0.0,67.41515981651057,2495.52,3091.32,72.20879489761658,-27.791205102383405,135.83277639909466,112.56203704911772,0.0905424495774982,10225464390.0,0
1198,2014-12-12,2929.36,2962.51,2914.96,2938.17,409480811.0,12.430000000000293,0.0,12.430000000000293,68.44603838690946,2527.08,3091.32,72.85729476818375,-27.14270523181625,135.38531011086934,117.12669166146806,0.0962666407975643,10634945201.0,1
1199,2014-12-15,2921.45,2960.23,2890.9,2953.42,400371695.0,15.25,0.0,15.25,69.79862550468528,2570.4,3091.32,73.5276050065269,-26.4723949934731,134.7084027897713,120.64303388712872,0.0687089747208291,11035316896.0,1
1200,2014-12-16,2953.81,3021.9,2943.91,3021.52,453842723.0,68.09999999999991,0.0,68.09999999999991,75.26241365626292,2599.11,3091.32,85.81906096991118,-14.18093903008882,138.07540243518133,124.12950759673924,0.0870653925857702,11489159619.0,1
1201,2014-12-17,3031.95,3076.6,2993.33,3061.02,542503179.0,39.5,0.0,39.5,77.93410663422375,2622.06,3091.32,93.54302518859475,-6.456974811405226,142.29085341166865,127.76177675972512,0.0557207204100074,12031662798.0,1
1202,2014-12-18,3062.8,3089.79,3030.32,3057.52,435904952.0,-3.5,3.5,0.0,77.08295597080101,2665.69,3091.32,92.05883043958364,-7.941169560416365,143.6928067019462,130.94798274816935,0.0408047248651133,11595757846.0,0
1203,2014-12-19,3053.07,3117.53,3018.42,3108.6,521073511.0,51.07999999999993,0.0,51.07999999999993,80.6429467724609,2665.69,3117.53,98.02363668555232,-1.976363314447656,147.22843612650058,134.2040734238356,0.029249137491474,12116831357.0,1
1204,2014-12-22,3129.27,3189.87,3090.51,3127.45,679371915.0,18.84999999999991,0.0,18.84999999999991,81.84388734741339,2733.87,3189.87,86.31140350877192,-13.688596491228086,149.82440292777255,137.328139324623,0.0949420047824609,12796203272.0,1
1205,2014-12-23,3085.08,3136.84,3025.67,3032.61,437762400.0,-94.83999999999968,94.83999999999968,0.0,60.17170342680088,2772.43,3189.87,62.327520122652416,-37.672479877347584,142.5852954025263,138.37957054020367,0.0314964915085322,12358440872.0,0
1206,2014-12-24,3039.21,3050.51,2934.91,2972.53,376805246.0,-60.07999999999993,60.07999999999993,0.0,50.41388221300434,2807.68,3189.87,43.13299667704554,-56.86700332295446,130.49601975850146,136.80286038386325,0.0159925352218586,11981635626.0,0
1207,2014-12-25,2992.46,3073.34,2969.87,3072.54,376947776.0,100.00999999999976,0.0,100.00999999999976,62.190547852650006,2807.68,3189.87,69.30060964441772,-30.69939035558228,127.51523662134788,134.94533563136017,0.0457325478103716,12358583402.0,1
1208,2014-12-26,3078.0,3164.16,3064.18,3157.6,460700932.0,85.05999999999995,0.0,85.05999999999995,69.33721683281925,2807.68,3189.87,91.556555639865,-8.443444360135006,130.51211323330608,134.05869115174934,0.0691334114348787,12819284334.0,1
1209,2014-12-29,3212.56,3223.86,3126.94,3168.02,510111439.0,10.420000000000073,0.0,10.420000000000073,70.13512736312032,2807.68,3223.86,86.58272862703636,-13.417271372963649,132.2040010263422,133.68775312666793,0.0484855304614895,13329395773.0,1
1210,2014-12-30,3160.8,3190.3,3130.35,3165.81,397725320.0,-2.2100000000000364,2.2100000000000364,0.0,69.69132073781722,2890.9,3223.86,82.56547333012969,-17.434526669870305,131.84665954195316,133.31953440972498,0.0342336868102788,12931670453.0,0
1211,2014-12-31,3172.6,3239.36,3157.26,3234.68,405998521.0,68.86999999999989,0.0,68.86999999999989,75.30927026411788,2890.9,3239.36,98.65694771279335,-1.3430522872066497,135.55806824173942,133.76724117612787,0.057942384677778,13337668974.0,1
1212,2015-01-05,3258.63,3369.28,3253.88,3350.52,531352391.0,115.84000000000016,0.0,115.84000000000016,81.84156320518535,2890.9,3369.28,96.07843137254898,-3.9215686274510255,146.16184351089714,136.2461616430817,0.0778228141285466,13869021365.0,1
1213,2015-01-06,3330.8,3394.22,3303.18,3351.45,501661695.0,0.9299999999998364,0.0,0.9299999999998364,81.88595671011117,2934.91,3394.22,90.68820622237703,-9.311793777622954,152.87817064757746,139.5725634439809,0.0716238469040273,14370683060.0,1
1214,2015-01-07,3326.65,3374.9,3312.21,3373.95,391918880.0,22.5,0.0,22.5,83.04321915398361,2934.91,3394.22,95.5868585486926,-4.413141451307393,158.1929207330386,143.29663490179243,0.1125565107283823,14762601940.0,1
1215,2015-01-08,3371.96,3381.57,3285.09,3293.46,371131170.0,-80.48999999999978,80.48999999999978,0.0,65.71391526825548,2934.91,3394.22,78.06274629335313,-21.93725370664688,154.13327569192597,145.46396305981915,0.1079652686432095,14391470770.0,0
1216,2015-01-09,3276.97,3404.83,3267.51,3285.41,410240872.0,-8.050000000000182,8.050000000000182,0.0,64.16865465481236,2934.91,3404.83,74.58716377255702,-25.41283622744298,148.5539723042525,146.08196490870583,0.0692814414132931,13981229898.0,0
1217,2015-01-12,3258.21,3275.19,3191.58,3229.32,322064679.0,-56.08999999999969,56.08999999999969,0.0,53.96621929369949,2934.91,3404.83,62.65108954715702,-37.34891045284298,138.01538449562713,144.4686488260901,0.0227134532556372,13659165219.0,0
1218,2015-01-13,3223.54,3259.39,3214.41,3235.3,230725754.0,5.980000000000018,0.0,5.980000000000018,54.849317271535085,2934.91,3404.83,63.92364657814103,-36.07635342185898,128.66286829803585,141.30749272047925,0.0212372396638911,13889890973.0,1
1219,2015-01-14,3242.34,3268.48,3193.98,3222.44,240190747.0,-12.860000000000127,12.860000000000127,0.0,52.35704730762178,2934.91,3404.83,61.18701055498812,-38.81298944501189,118.84328588342078,136.81465135306755,0.0178879970686807,13649700226.0,0
1220,2015-01-15,3224.07,3337.08,3207.54,3336.46,282546240.0,114.01999999999998,0.0,114.01999999999998,67.47585922681643,2969.87,3404.83,84.28131322420455,-15.71868677579545,118.8911539530718,133.2299518730684,0.0314652454029455,13932246466.0,1
1221,2015-01-16,3343.6,3400.32,3340.49,3376.5,339876753.0,40.03999999999997,0.0,40.03999999999997,71.18140919927498,3064.18,3404.83,91.68354616174962,-8.31645383825038,120.7678465551844,130.7375308094916,0.0077540202714803,14272123219.0,1
1222,2015-01-19,3189.73,3262.21,3095.07,3116.35,401098789.0,-260.1500000000001,260.1500000000001,0.0,38.39071092478118,3095.07,3404.83,6.869834710743724,-93.13016528925628,100.10921145364637,124.61186693832256,-0.0701487415894612,13871024430.0,0
1223,2015-01-20,3114.56,3190.25,3100.48,3173.05,357080811.0,56.70000000000027,0.0,56.70000000000027,44.78705914331025,3095.07,3404.83,25.17432851239672,-74.82567148760329,87.30590234043439,117.15067401874494,-0.0595444508661953,14228105241.0,1
1224,2015-01-21,3189.08,3337.0,3178.34,3323.61,410956024.0,150.55999999999997,0.0,150.55999999999997,58.111643633638,3095.07,3404.83,73.77970041322318,-26.22029958677681,88.29036497435163,111.37861220986628,0.0091545062032027,14639061265.0,1
1225,2015-01-22,3327.32,3352.38,3293.98,3343.34,353382961.0,19.730000000000015,0.0,19.730000000000015,59.58635229914216,3095.07,3404.83,80.14914772727279,-19.850852272727217,89.62941273625938,107.02877231514488,0.0176325024882739,14992444226.0,1
1226,2015-01-23,3357.1,3406.79,3328.29,3351.76,366249240.0,8.420000000000073,0.0,8.420000000000073,60.27501968532324,3095.07,3406.79,82.34633645579373,-17.653663544206267,90.32878733335292,103.68877531878653,0.037915102869954,15358693466.0,1
1227,2015-01-26,3347.26,3384.8,3321.31,3383.18,317541007.0,31.419999999999614,0.0,31.419999999999614,62.99044186433397,3095.07,3406.79,92.42589503400484,-7.574104965995169,92.35378125035412,101.42177650510006,0.0457082805303989,15676234473.0,1
1228,2015-01-27,3389.85,3390.22,3290.22,3352.96,374517551.0,-30.2199999999998,30.2199999999998,0.0,58.54894908437079,3095.07,3406.79,82.731297318106,-17.268702681893995,90.4771379517042,99.2328487944209,0.0405034694206873,15301716922.0,0
1229,2015-01-28,3325.72,3354.8,3294.66,3305.74,301927095.0,-47.220000000000255,47.220000000000255,0.0,51.94535386778547,3095.07,3406.79,67.58308738611566,-32.416912613884335,84.2089172709766,96.22806248973204,-0.0092073634930436,14999789827.0,0
1230,2015-01-29,3259.0,3286.79,3234.24,3262.3,274658613.0,-43.4399999999996,43.4399999999996,0.0,46.39130530167254,3095.07,3406.79,53.64750417040938,-46.352495829590616,74.87297323597886,91.95704463898144,-0.0338220050347992,14725131214.0,0
1231,2015-01-30,3273.75,3288.5,3210.31,3210.36,258312548.0,-51.940000000000055,51.940000000000055,0.0,40.427782072367634,3095.07,3406.79,36.98511484665727,-63.01488515334274,62.561872089060216,86.07801012899719,0.030166701429557,14466818666.0,0
1232,2015-02-02,3148.14,3175.13,3122.57,3128.3,250861629.0,-82.05999999999995,82.05999999999995,0.0,32.752587234140776,3095.07,3406.79,10.66020787886566,-89.33979212113434,45.65736979914891,77.99388206302754,-0.0141031499661209,14215957037.0,0
1233,2015-02-03,3156.09,3207.94,3129.73,3204.91,248192164.0,76.60999999999967,0.0,76.60999999999967,44.1702460978663,3095.07,3406.79,35.23675093032201,-64.763249069678,38.00412874808899,69.99593140003984,-0.0357141782579786,14464149201.0,1
1234,2015-02-04,3212.82,3238.98,3171.14,3174.13,249098086.0,-30.779999999999745,30.779999999999745,0.0,40.94726717826488,3095.07,3406.79,25.362504812010776,-74.63749518798922,29.119519619787752,61.82064904398942,-0.0506110655811254,14215051115.0,0
1235,2015-02-05,3251.21,3251.21,3135.82,3136.53,306139305.0,-37.59999999999991,37.59999999999991,0.0,37.128667390224535,3095.07,3406.79,13.300397792891076,-86.69960220710892,18.827366945251924,53.22199262424191,-0.0642140248705157,13908911810.0,0
1236,2015-02-06,3120.09,3129.54,3052.94,3075.91,246749666.0,-60.620000000000346,60.620000000000346,0.0,31.639733150594964,3052.94,3406.79,6.491451179878424,-93.50854882012158,5.713374200869112,43.72026893956736,-0.0908228353206155,13662162144.0,0
1237,2015-02-09,3063.51,3119.03,3049.11,3095.12,206108383.0,19.21000000000004,0.0,19.21000000000004,35.145462403845826,3049.11,3406.79,12.86345336613727,-87.13654663386274,-3.0938095641135988,34.35745323883116,-0.0768992174079022,13868270527.0,1
1238,2015-02-10,3090.49,3142.1,3084.25,3141.59,193817139.0,46.470000000000255,0.0,46.470000000000255,43.26643282512947,3049.11,3406.79,25.855513307984808,-74.14448669201519,-6.251759128540016,26.235610765356924,-0.0496560528051206,14062087666.0,1
1239,2015-02-11,3145.76,3166.42,3139.05,3157.7,172840094.0,16.109999999999673,0.0,16.109999999999673,45.97258684126162,3049.11,3406.79,30.35953925296347,-69.64046074703653,-7.369562814303208,19.5145760494249,-0.0320632682463294,14234927760.0,1
1240,2015-02-12,3157.96,3181.77,3134.24,3173.42,194592309.0,15.720000000000256,0.0,15.720000000000256,48.72625959399917,3049.11,3390.22,36.44278971592743,-63.55721028407256,-6.907334216946765,14.230193996150566,-0.011506497713652,14429520069.0,1
1241,2015-02-13,3186.81,3237.16,3182.79,3203.83,261290436.0,30.40999999999985,0.0,30.40999999999985,53.96360531891549,3049.11,3390.22,45.35780246841193,-54.64219753158807,-4.040604299166262,10.5760343370872,0.0241441038263592,14690810505.0,1
1242,2015-02-16,3206.14,3228.85,3195.88,3222.36,223797429.0,18.5300000000002,0.0,18.5300000000002,57.04824249210864,3049.11,3354.8,56.67506297229218,-43.32493702770782,-0.2703674200029127,8.406753985669178,0.005444770679988,14914607934.0,1
1243,2015-02-17,3230.88,3255.73,3230.77,3246.91,228332624.0,24.549999999999727,0.0,24.549999999999727,61.03901269511998,3049.11,3288.5,82.62667613517684,-17.373323864823163,4.645007541392715,7.654404696813885,0.0229291175849759,15142940558.0,1
1244,2015-02-25,3256.48,3257.22,3215.55,3228.84,233348094.0,-18.06999999999971,18.06999999999971,0.0,56.57471907456458,3049.11,3288.5,75.07832407368734,-24.921675926312663,7.001668749991495,7.523857507449407,0.0294306128109727,14909592464.0,0
1245,2015-02-26,3222.15,3300.62,3202.19,3298.36,301263875.0,69.51999999999998,0.0,69.51999999999998,67.2180867444435,3049.11,3300.62,99.10142737863316,-0.8985726213668505,14.314019625674518,8.881889931094431,0.0723200613802095,15210856339.0,1
1246,2015-02-27,3296.83,3324.55,3291.01,3310.3,299163717.0,11.940000000000056,0.0,11.940000000000056,68.73658838993164,3049.11,3324.55,94.826459483009,-5.173540516990995,20.832425358751152,11.271997016625775,0.0695223448525421,15510020056.0,1
1247,2015-03-02,3332.72,3336.76,3298.67,3336.28,346445671.0,25.980000000000015,0.0,25.980000000000015,71.9936112694238,3049.11,3336.76,99.83313054058752,-0.1668694594124867,27.774510473170267,14.57249970793468,0.0619718040864658,15856465727.0,1
1248,2015-03-03,3317.7,3317.7,3260.43,3263.05,382044619.0,-73.23000000000002,73.23000000000002,0.0,53.77351520431479,3049.11,3336.76,74.37510863897097,-25.62489136102904,27.05523800756509,17.069047367860765,0.0333628907115939,15474421108.0,0
1249,2015-03-04,3264.18,3286.59,3250.48,3279.53,293639522.0,16.480000000000018,0.0,16.480000000000018,56.6240218949086,3049.11,3336.76,80.1042934121328,-19.8957065878672,27.498027523030487,19.154843398894712,0.0334371120116467,15768060630.0,1
1250,2015-03-05,3264.08,3266.64,3221.67,3248.48,320663585.0,-31.050000000000185,31.050000000000185,0.0,49.93057167960579,3049.11,3336.76,69.30992525638791,-30.69007474361209,25.05465147363157,20.33480501384209,0.0139364448176089,15447397045.0,0
1251,2015-03-06,3248.04,3266.93,3234.53,3241.19,282915791.0,-7.289999999999964,7.289999999999964,0.0,48.38125469537996,3084.25,3336.76,62.15199398043638,-37.84800601956361,22.27326395374712,20.72249680182309,0.0058435432415993,15164481254.0,0
1252,2015-03-09,3224.31,3307.7,3198.37,3302.41,321495440.0,61.2199999999998,0.0,61.2199999999998,60.31367054539125,3134.24,3336.76,83.03871222595285,-16.96128777404715,24.723934541259496,21.522784349710378,0.0170931747415234,15485976694.0,1
1253,2015-03-10,3289.08,3309.92,3277.09,3286.07,285817576.0,-16.33999999999969,16.33999999999969,0.0,56.30522258542191,3134.24,3336.76,74.97037329646457,-25.029626703535424,25.0587455765899,22.229976595086285,0.0177246317562964,15200159118.0,0
1254,2015-03-11,3289.59,3325.05,3278.47,3290.9,282985535.0,4.829999999999927,0.0,4.829999999999927,57.273720200956085,3182.79,3336.76,70.2149769435604,-29.7850230564396,25.420791309950346,22.8681395380591,-0.0022617300719145,15483144653.0,1
1255,2015-03-12,3314.81,3360.05,3300.49,3349.32,357295105.0,58.42000000000007,0.0,58.42000000000007,67.36799479550854,3195.88,3360.05,93.4640920996528,-6.53590790034721,30.075034647370103,24.309518559921305,0.0117874512884028,15840439758.0,1
1256,2015-03-13,3359.49,3391.25,3352.15,3372.91,328410154.0,23.58999999999969,0.0,23.58999999999969,70.60382116775781,3198.37,3391.25,90.49149730402316,-9.508502695976844,35.26060951688851,26.499736751314757,0.0109792943038353,16168849912.0,1
1257,2015-03-16,3391.16,3449.3,3377.09,3449.3,399132430.0,76.39000000000033,0.0,76.39000000000033,78.55089302289427,3198.37,3449.3,100.0,-0.0,45.01534071646074,30.202857544343956,0.0570785001762155,16567982342.0,1
1258,2015-03-17,3469.6,3504.12,3459.69,3502.85,520939506.0,53.54999999999973,0.0,53.54999999999973,82.39956234515677,3198.37,3504.12,99.5846279640229,-0.4153720359770995,56.416735921636246,35.44563321980242,0.0680951233865827,17088921848.0,1
1259,2015-03-18,3510.5,3577.66,3503.85,3577.3,545217144.0,74.45000000000027,0.0,74.45000000000027,86.33338992037294,3198.37,3577.66,99.90508581823944,-0.0949141817605717,70.64555853627007,42.48561828309595,0.1012227257055609,17634138992.0,1
1260,2015-03-19,3576.02,3600.68,3546.84,3582.27,537346614.0,4.9699999999998,0.0,4.9699999999998,86.56469175703778,3198.37,3600.68,95.42392682259953,-4.576073177400477,81.38488612851961,50.26547185218069,0.1052329545629846,18171485606.0,1
1261,2015-03-20,3587.08,3632.34,3569.38,3617.32,516661669.0,35.05000000000018,0.0,35.05000000000018,88.19102658575241,3198.37,3632.34,96.53893126252969,-3.4610687374703257,91.6674375340881,58.54586498856217,0.0953576327591063,18688147275.0,1
1262,2015-03-23,3640.1,3688.25,3635.49,3687.73,536062832.0,70.40999999999985,0.0,70.40999999999985,90.77841733205562,3198.37,3688.25,99.89385155548298,-0.1061484445170208,104.29567652666584,67.69582729618291,0.1222311149792914,19224210107.0,1
1263,2015-03-24,3692.57,3715.87,3600.7,3691.41,639554669.0,3.679999999999836,0.0,3.679999999999836,90.89867584776512,3198.37,3715.87,95.27342995169082,-4.726570048309186,113.29460250060448,76.81558233706723,0.121702269895773,19863764776.0,1
1264,2015-03-25,3680.95,3693.15,3634.56,3660.73,521886348.0,-30.67999999999984,30.67999999999984,0.0,80.76661684378784,3198.37,3715.87,89.3449275362319,-10.655072463768091,116.60652908986503,84.77377168762679,0.0929770819151349,19341878428.0,0
1265,2015-03-26,3641.94,3707.32,3615.01,3682.09,488647203.0,21.360000000000127,0.0,21.360000000000127,82.34730089684251,3198.37,3715.87,93.472463768116,-6.527536231884008,119.57642565877497,91.73430248185645,0.0916656536936948,19830525631.0,1
1266,2015-03-27,3686.134,3710.477,3710.477,3691.096,408945165.0,9.005999999999858,0.0,9.005999999999858,83.02596230177394,3277.09,3715.87,94.353890332285,-5.646109667715005,121.2590007408694,97.63924213365904,0.0701000202939725,20239470796.0,1
1267,2015-03-30,3710.61,3795.94,3710.61,3786.57,564702353.0,95.47400000000016,0.0,95.47400000000016,88.45512069863157,3278.47,3795.94,98.18926701064798,-1.8107329893520177,128.8115481614177,103.8737033392108,0.0809969025222319,20804173149.0,1
1268,2015-03-31,3822.99,3835.57,3737.04,3747.9,561676037.0,-38.67000000000007,38.67000000000007,0.0,76.95226393310807,3300.49,3835.57,83.6155341257382,-16.384465874261796,130.17606197339865,109.13417506604836,0.0476895983003942,20242497112.0,0
1269,2015-04-01,3748.34,3817.08,3742.21,3810.29,447458319.0,62.38999999999987,0.0,62.38999999999987,81.44434630595086,3352.15,3835.57,94.7705928592114,-5.229407140788589,134.73861767254675,114.25506358734803,0.0636523768448498,20689955431.0,1
1270,2015-04-02,3827.69,3835.45,3775.89,3825.78,479299673.0,15.490000000000236,0.0,15.490000000000236,82.42560637827427,3377.09,3835.57,97.86468330134358,-2.135316698656422,138.01345626677812,119.00674212323406,0.0576282994039787,21169255104.0,1
1271,2015-04-03,3803.38,3864.41,3792.21,3863.93,473033311.0,38.14999999999964,0.0,38.14999999999964,84.72162803162453,3459.69,3864.41,99.88139948606444,-0.1186005139355649,142.0497149230364,123.61533668319451,0.0477800706667788,21642288415.0,1
1272,2015-04-07,3899.42,3961.67,3891.73,3961.38,570447535.0,97.45000000000029,0.0,97.45000000000029,88.96917954018541,3503.85,3961.67,99.93665632781445,-0.0633436721855671,151.36701483978595,129.16567231451282,0.0731346558632068,22212735950.0,1
1273,2015-04-08,3976.53,4000.22,3903.65,3994.81,618085419.0,33.42999999999984,0.0,33.42999999999984,90.06271248203245,3546.84,4000.22,98.8067404825974,-1.193259517402589,159.60869409262614,135.25427667013548,0.091260486296449,22830821369.0,1
1274,2015-04-09,4006.13,4016.4,3900.03,3957.53,585176825.0,-37.27999999999975,37.27999999999975,0.0,79.8740496179122,3569.38,4016.4,86.83056686501725,-13.16943313498275,161.27304457171613,140.45803025045163,0.0748053415315759,22245644544.0,0
1275,2015-04-10,3947.49,4040.35,3929.32,4034.31,484283619.0,76.77999999999975,0.0,76.77999999999975,84.13829469608622,3600.7,4040.35,98.62617991584216,-1.3738200841578443,166.86405369839122,145.73923494003955,0.0929843060164243,22729928163.0,1
1276,2015-04-13,4072.72,4128.07,4057.29,4121.71,589814227.0,87.40000000000009,0.0,87.40000000000009,87.59146191081044,3600.7,4128.07,98.79401558677974,-1.205984413220258,176.31496906888106,151.85438176580786,0.0885075411256097,23319742390.0,1
1277,2015-04-14,4125.78,4168.35,4091.26,4135.56,610683541.0,13.850000000000364,0.0,13.850000000000364,88.06649304015771,3615.01,4168.35,94.07416778111109,-5.925832218888921,182.8150883013859,158.0465230729235,0.1034339229968783,23930425931.0,1
1278,2015-04-15,4135.65,4175.49,4069.01,4084.16,613005812.0,-51.40000000000055,51.40000000000055,0.0,75.66294468856869,3615.01,4175.49,83.70503853839566,-16.294961461604338,181.7241265798289,162.78204377430458,0.0718764188552576,23317420119.0,0
1279,2015-04-16,4055.92,4195.31,4031.24,4194.82,551242956.0,110.65999999999984,0.0,110.65999999999984,81.97085841210752,3710.477,4195.31,99.89893427221318,-0.1010657277868236,187.62603262043424,167.75084154353053,0.0964613751966918,23868663075.0,1
1280,2015-04-17,4254.72,4317.22,4238.91,4287.3,701706205.0,92.48000000000047,0.0,92.48000000000047,85.57590812169313,3710.61,4317.22,95.067671156097,-4.932328843903013,197.48916661098883,173.6985065570222,0.1095697903429928,24570369280.0,1
1281,2015-04-20,4301.35,4356.0,4190.68,4217.08,857132807.0,-70.22000000000025,70.22000000000025,0.0,72.81908993399591,3737.04,4356.0,77.5559002197234,-22.4440997802766,197.3645090068817,178.43170704699412,0.0645482129964809,23713236473.0,0
1282,2015-04-21,4212.19,4294.38,4188.57,4293.62,634470627.0,76.53999999999996,0.0,76.53999999999996,77.11052229583936,3742.21,4356.0,89.83691490574951,-10.163085094250494,201.1234295847821,182.97005155455173,0.0747995524192639,24347707100.0,1
1283,2015-04-22,4304.6,4400.19,4297.95,4398.49,680305086.0,104.86999999999988,0.0,104.86999999999988,81.6825934427278,3775.89,4400.19,99.72769501842066,-0.2723049815793399,210.1421459397211,188.4044704315856,0.1114230340641762,25028012186.0,1
1284,2015-04-23,4414.48,4444.41,4358.84,4414.51,667344661.0,16.020000000000437,0.0,16.020000000000437,82.30557155206982,3792.21,4444.41,95.41551671266488,-4.584483287335119,216.09125822989017,193.94182799124656,0.0942416423130598,25695356847.0,1
1285,2015-04-24,4355.95,4416.38,4318.12,4393.69,628554996.0,-20.82000000000062,20.82000000000062,0.0,78.31163454712524,3891.73,4444.41,90.82289932691609,-9.177100673083933,216.62881050019405,198.47922449303607,0.0659871752258163,25066801851.0,0
1286,2015-04-27,4441.93,4529.73,4441.93,4527.4,671088521.0,133.71000000000004,0.0,133.71000000000004,84.0478190629175,3900.03,4529.73,99.62998253136416,-0.3700174686358471,225.2475900794907,203.83289761032705,0.0947489578194971,25737890372.0,1
1287,2015-04-28,4527.63,4572.39,4432.9,4476.21,767676416.0,-51.1899999999996,51.1899999999996,0.0,75.25549558471907,3900.03,4572.39,85.69516330537208,-14.304836694627918,225.3497382959822,208.1362657474581,0.0959928112512733,24970213956.0,0
1288,2015-04-29,4446.12,4499.94,4398.64,4476.62,519834202.0,0.4099999999998545,0.0,0.4099999999998545,75.27939476155294,3929.32,4572.39,85.10737555787078,-14.892624442129229,222.89438731692556,211.0878900613517,0.0671780910742296,25490048158.0,1
1289,2015-04-30,4483.01,4507.34,4441.05,4441.65,526727975.0,-34.970000000000255,34.970000000000255,0.0,68.74500531387109,4031.24,4572.39,75.84034001663115,-24.15965998336885,215.6409426773007,211.99850058454143,0.0360016793786297,24963320183.0,0
1290,2015-05-04,4441.34,4487.57,4387.43,4480.46,494173398.0,38.8100000000004,0.0,38.8100000000004,71.87158870731325,4031.24,4572.39,83.01210385290581,-16.98789614709419,210.59655223112983,211.71811091385916,0.0624555379551727,25457493581.0,1
1291,2015-05-05,4479.85,4488.87,4282.24,4298.71,572858596.0,-181.75,181.75,0.0,46.65344973724302,4031.24,4572.39,49.42622193476854,-50.57377806523146,189.74585826639668,207.32366038436663,0.0011854798515005,24884634985.0,0
1292,2015-05-06,4311.64,4376.35,4187.37,4229.27,481732993.0,-69.4399999999996,69.4399999999996,0.0,40.40373117033207,4031.24,4572.39,36.59428993809488,-63.40571006190512,165.70812529384057,199.00055336626147,-0.0384722939008612,24402901992.0,0
1293,2015-05-07,4197.9,4213.76,4108.01,4112.21,394566653.0,-117.0600000000004,117.0600000000004,0.0,32.05196887770967,4108.01,4572.39,0.9044317154054476,-99.09556828459456,135.6486122778051,186.33016514857025,-0.0684787213076876,24008335339.0,0
1294,2015-05-08,4152.98,4206.86,4099.04,4205.92,397428094.0,93.71000000000004,0.0,93.71000000000004,42.945567445557565,4099.04,4572.39,22.57948663779445,-77.42051336220554,118.02730023073671,172.66959216500354,-0.0427362877217099,24405763433.0,1
1295,2015-05-11,4231.27,4334.88,4187.82,4333.58,488750515.0,127.65999999999984,0.0,127.65999999999984,54.42959419222729,4099.04,4572.39,49.548959543678,-50.451040456322005,113.060092214022,160.74769217480724,-0.0428104430799133,24894513948.0,1
1296,2015-05-12,4342.37,4402.31,4317.98,4401.22,521866408.0,67.64000000000033,0.0,67.64000000000033,59.42284175994888,4099.04,4572.39,63.83859723249182,-36.16140276750817,113.2757543979178,151.25330461942937,-0.0167530120347346,25416380356.0,1
1297,2015-05-13,4402.38,4415.63,4342.48,4375.76,510490475.0,-25.46000000000004,25.46000000000004,0.0,56.723452196585086,4099.04,4572.39,58.45991338333158,-41.54008661666842,110.12283155740442,143.0272100070244,-0.0225303912326709,24905889881.0,0
1298,2015-05-14,4372.82,4397.75,4329.04,4378.31,449077935.0,2.550000000000182,0.0,2.550000000000182,56.94945844912117,4099.04,4572.39,58.99862680891522,-41.00137319108477,106.60105062472394,135.7419781305643,-0.0142604662681659,25354967816.0,1
1299,2015-05-15,4366.82,4366.82,4278.55,4308.69,439706198.0,-69.6200000000008,69.6200000000008,0.0,48.90394946822178,4099.04,4572.39,44.29069398964814,-55.70930601035185,97.07326156778343,128.00823481800813,-0.0383375814090518,24915261618.0,0
1300,2015-05-18,4277.9,4324.83,4260.51,4283.49,380057452.0,-25.199999999999815,25.199999999999815,0.0,46.179210767772354,4099.04,4572.39,38.96693778388078,-61.03306221611922,86.49196516627399,119.7049808876613,-0.0035405970628398,24535204166.0,0
1301,2015-05-19,4285.78,4418.4,4285.78,4417.55,436735224.0,134.0600000000004,0.0,134.0600000000004,59.89512296529964,4099.04,4507.34,78.00881704628951,-21.99118295371049,87.91035727145845,113.34605616442074,0.0445183211287054,24971939390.0,1
1302,2015-05-20,4434.98,4520.54,4432.28,4446.29,514106223.0,28.73999999999978,0.0,28.73999999999978,62.273375865704885,4099.04,4520.54,82.38434163701068,-17.615658362989322,90.31245527670036,108.73933598687668,0.0812409872063926,25486045613.0,1
1303,2015-05-21,4456.44,4530.48,4438.26,4529.42,464996520.0,83.13000000000011,0.0,83.13000000000011,68.50643915550013,4099.04,4530.48,99.75431114407576,-0.2456888559242285,97.79669211526108,106.55080721255356,0.0769153954426142,25951042133.0,1
1304,2015-05-22,4584.98,4658.27,4562.99,4657.6,655591287.0,128.1800000000003,0.0,128.1800000000003,75.66079291430307,4099.04,4658.27,99.88019240741734,-0.1198075925826712,112.77110340341824,107.79486645072652,0.074769590038721,26606633420.0,1
1305,2015-05-25,4660.08,4814.67,4656.83,4813.8,682461391.0,156.19999999999982,0.0,156.19999999999982,81.55305201356438,4099.04,4814.67,99.87842879700403,-0.1215712029959463,135.67845010036854,113.37158318065494,0.0937421896655927,27289094811.0,1
1306,2015-05-26,4854.85,4911.69,4779.08,4910.9,704892829.0,97.09999999999944,0.0,97.09999999999944,84.28234023277138,4099.04,4911.69,99.9027871777518,-0.0972128222481959,159.82547728344434,122.66236200121284,0.1222964696418449,27993987640.0,1
1307,2015-05-27,4932.85,4958.16,4857.06,4941.71,681165379.0,30.8100000000004,0.0,30.8100000000004,85.08999020293223,4099.04,4958.16,98.08525002327966,-1.914749976720344,179.38049314159798,134.00598822928987,0.1286797874065564,28675153019.0,1
1308,2015-05-28,4943.74,4986.5,4614.24,4620.27,782964592.0,-321.4399999999996,321.4399999999996,0.0,52.570971658205536,4187.82,4986.5,54.145590223869455,-45.85440977613055,167.0152150459462,140.60783359262115,0.0723143229148537,27892188427.0,0
1309,2015-05-29,4603.46,4698.19,4431.56,4611.74,611262409.0,-8.530000000000655,8.530000000000655,0.0,51.96290748227716,4260.51,4986.5,48.37945426245536,-51.620545737544646,154.74355596763144,143.4349780676232,0.0766314383831876,27280926018.0,0
1310,2015-06-01,4633.1,4829.5,4615.23,4828.74,593389035.0,217.0,0.0,217.0,64.1385077253266,4260.51,4986.5,78.26967313599357,-21.73032686400643,160.67609023997738,146.88320050209404,0.0930810064402212,27874315053.0,1
1311,2015-06-02,4844.7,4911.57,4797.55,4910.53,623748099.0,81.78999999999996,0.0,81.78999999999996,67.69905884038268,4260.51,4986.5,89.53566853537923,-10.464331464620765,170.01757902611735,151.5100762068987,0.1044106434802947,28498063152.0,1
1312,2015-06-03,4924.38,4942.06,4822.44,4909.98,611453839.0,-0.5500000000001819,0.5500000000001819,0.0,67.64694567563882,4260.51,4986.5,89.45990991611448,-10.540090083885516,175.35501235968968,156.2790634374569,0.0840195874968539,27886609313.0,0
1313,2015-06-04,4912.94,4947.96,4647.41,4947.1,674952402.0,37.1200000000008,0.0,37.1200000000008,69.47668690113656,4260.51,4986.5,94.57292800176316,-5.427071998236841,180.49955400440103,161.12316155084574,0.0621564754379937,28561561715.0,1
1314,2015-06-05,5016.09,5051.63,4898.07,5023.1,772240812.0,76.0,0.0,76.0,73.07415724820336,4285.78,5051.63,96.27472742704188,-3.725272572958116,188.53588088838387,166.60570541835338,0.0434791640699656,29333802527.0,1
1315,2015-06-08,5045.69,5146.95,4997.48,5131.88,855035085.0,108.77999999999976,0.0,108.77999999999976,77.4612663220425,4431.56,5146.95,97.89345671591722,-2.106543284082769,201.36119818052703,173.55680397078814,0.0449978618990409,30188837612.0,1
1316,2015-06-09,5145.98,5147.45,5042.96,5113.53,729893818.0,-18.350000000000364,18.350000000000364,0.0,75.08021075424776,4431.56,5147.45,95.26184190308564,-4.738158096914344,207.65099152131643,180.37564148089385,0.034769340977111,29458943794.0,0
1317,2015-06-10,5049.2,5164.16,5001.49,5106.04,596969001.0,-7.489999999999782,7.489999999999782,0.0,74.0087855173607,4431.56,5164.16,92.06661206661208,-7.933387933387924,209.6150063436289,186.22351445344088,0.1051388771651871,28861974793.0,0
1318,2015-06-11,5101.44,5122.46,5050.77,5121.59,563990522.0,15.550000000000182,0.0,15.550000000000182,74.86792029489321,4431.56,5164.16,94.18918918918922,-5.810810810810776,210.0054452346867,190.97990060969005,0.1105548014415385,29425965315.0,1
1319,2015-06-12,5143.34,5178.19,5103.4,5166.35,625627854.0,44.76000000000022,0.0,44.76000000000022,77.35409683234994,4431.56,5178.19,98.41420784056368,-1.5857921594363005,211.4887184942372,195.0816641865995,0.069916789887217,30051593169.0,1
1320,2015-06-15,5174.42,5176.79,5048.74,5062.99,637803984.0,-103.36000000000058,103.36000000000058,0.0,61.218161416902696,4431.56,5178.19,84.57067088115934,-15.429329118840649,201.99545716204105,196.46442278168783,0.0310475651304442,29413789185.0,0
1321,2015-06-16,5004.41,5029.68,4842.1,4887.43,550801407.0,-175.5599999999995,175.5599999999995,0.0,43.45351063483809,4431.56,5178.19,61.05701619275952,-38.94298380724048,178.25098794551195,192.8217358144527,-0.0045926867319213,28862987778.0,0
1322,2015-06-17,4890.55,4983.66,4767.22,4967.9,537101168.0,80.46999999999935,0.0,80.46999999999935,50.97719977324856,4431.56,5178.19,71.83477760068571,-28.16522239931428,164.03568029215603,187.06452470999332,0.0042044834347394,29400088946.0,1
1323,2015-06-18,4942.52,4966.77,4780.87,4785.36,507440899.0,-182.54,182.54,0.0,37.80976612739135,4615.23,5178.19,30.220619582208347,-69.77938041779166,136.4673830675365,176.945096381502,-0.0473293384563319,28892648047.0,0
1324,2015-06-19,4689.93,4744.08,4476.5,4478.36,452689626.0,-307.0,307.0,0.0,25.185541920372017,4476.5,5178.19,0.2650743205688656,-99.73492567943111,88.82307745773596,159.3206925967488,-0.1273451444694732,28439958421.0,0
1325,2015-06-23,4471.61,4577.94,4264.77,4576.49,473526128.0,98.13000000000012,0.0,98.13000000000012,33.38834460256389,4264.77,5178.19,34.1266887083707,-65.8733112916293,58.31072317703456,139.11869871280598,-0.1050233400410284,28913484549.0,1
1326,2015-06-24,4604.58,4691.77,4552.13,4690.15,543003709.0,113.65999999999984,0.0,113.65999999999984,41.90158289946614,4264.77,5178.19,46.57003350047072,-53.42996649952929,42.80741742232931,119.85644245471065,-0.0814505957650155,29456488258.0,1
1327,2015-06-25,4711.76,4720.7,4483.55,4527.78,572797533.0,-162.3699999999999,162.3699999999999,0.0,34.61041060812835,4264.77,5178.19,28.79398305270298,-71.20601694729703,17.220526390326995,99.32925924183392,-0.1159425100408272,28883690725.0,0
1328,2015-06-26,4399.93,4456.9,4139.53,4192.87,565217874.0,-334.90999999999985,334.90999999999985,0.0,24.47469442900703,4139.53,5178.19,5.135463000404382,-94.8645369995956,-29.7388956591376,73.5156282616396,-0.1884270326245802,28318472851.0,0
1329,2015-06-29,4289.77,4297.48,3875.05,4053.03,673786349.0,-139.8399999999997,139.8399999999997,0.0,21.448506144188187,3875.05,5178.19,13.657780438018946,-86.34221956198105,-77.3468884824033,43.343124912831016,-0.1994789640113845,27644686502.0,0
1330,2015-06-30,4006.75,4279.97,3847.88,4277.22,709176633.0,224.19000000000003,0.0,224.19000000000003,36.07066732713101,3847.88,5178.19,32.27368057069408,-67.72631942930593,-95.88104937262688,15.498290055739432,-0.1248529390702271,28353863135.0,1
1331,2015-07-01,4214.15,4317.05,4043.37,4053.7,598769427.0,-223.52000000000044,223.52000000000044,0.0,29.70873148231321,3847.88,5178.19,15.471581811758146,-84.52841818824184,-127.14010933650388,-13.02938982270924,-0.1840214175003522,27755093708.0,0
1332,2015-07-02,4058.62,4080.39,3795.25,3912.77,586015612.0,-140.92999999999984,140.92999999999984,0.0,26.330225745556334,3795.25,5178.19,8.497837939462306,-91.5021620605377,-161.42421489980916,-42.70835483812923,-0.1823457378337261,27169078096.0,0
1333,2015-07-03,3793.71,3927.13,3629.56,3686.92,548163111.0,-225.8499999999999,225.8499999999999,0.0,21.755420730609345,3629.56,5176.79,3.707270412285189,-96.2927295877148,-204.46191339071996,-75.0590665486474,-0.1767254084084352,26620914985.0,0
1334,2015-07-06,3975.21,3975.21,3653.04,3775.91,831139286.0,88.98999999999978,0.0,88.98999999999978,27.483681402629145,3629.56,5029.68,10.452675484958425,-89.54732451504158,-228.7519402609132,-105.79764129110058,-0.1749331911574153,27452054271.0,1
1335,2015-07-07,3654.78,3750.57,3585.4,3727.12,698818688.0,-48.78999999999997,48.78999999999997,0.0,26.26716161478552,3585.4,4983.66,10.135454064337091,-89.8645459356629,-249.0678081476917,-134.45167466241884,-0.2053303199258018,26753235583.0,0
1336,2015-07-08,3467.4,3599.25,3421.52,3507.19,680356922.0,-219.92999999999984,219.92999999999984,0.0,21.35157133568876,3421.52,4966.77,5.5440867173596535,-94.45591328264037,-279.69069258151967,-163.49947824623902,-0.225406269739254,26072878661.0,0
1337,2015-07-09,3432.45,3748.48,3373.54,3709.33,656914612.0,202.13999999999987,0.0,202.13999999999987,34.37555562787661,3373.54,4744.08,24.500561822347397,-75.4994381776526,-284.370494430455,-187.67368148308225,-0.1153243482387958,26729793273.0,1
1338,2015-07-10,3707.46,3959.22,3677.44,3877.8,586364255.0,168.47000000000023,0.0,168.47000000000023,43.39046960713882,3373.54,4720.7,37.43133703494762,-62.56866296505239,-271.3571141761413,-204.4103680216941,-0.0432343209894819,27316157528.0,1
1339,2015-07-13,3918.99,4030.2,3858.64,3970.39,643489007.0,92.58999999999968,0.0,92.58999999999968,47.92675149333719,3373.54,4720.7,44.30431426111227,-55.69568573888773,-250.6829602540865,-213.6648864681726,-0.0717358471156499,27959646535.0,1
1340,2015-07-14,3958.37,4035.44,3855.56,3924.49,670558799.0,-45.90000000000009,45.90000000000009,0.0,45.82625779093121,3373.54,4720.7,40.89714658986311,-59.10285341013689,-235.290013902003,-217.98991195493872,-0.0318745837136443,27289087736.0,0
1341,2015-07-15,3874.97,3914.27,3741.25,3805.7,601301324.0,-118.78999999999996,118.78999999999996,0.0,40.52281270433642,3373.54,4456.9,39.89071038251366,-60.10928961748634,-230.024770875134,-220.39688373897775,-0.0273642457900669,26687786412.0,0
1342,2015-07-16,3758.5,3877.51,3688.44,3823.18,492256200.0,17.480000000000018,0.0,17.480000000000018,41.66899214875498,3373.54,4317.05,47.65609267522334,-52.34390732477666,-221.8837996047937,-220.69426691214096,0.0369576774109554,27180042612.0,1
1343,2015-07-17,3831.42,3994.48,3814.15,3957.35,481726268.0,134.17000000000007,0.0,134.17000000000007,50.173086623123865,3373.54,4317.05,61.87639770643658,-38.12360229356342,-202.27393550860324,-217.0102006314334,0.0480519927646581,27661768880.0,1
1344,2015-07-20,3948.42,4021.33,3927.12,3992.11,539106714.0,34.76000000000022,0.0,34.76000000000022,52.25392581561936,3373.54,4317.05,65.56051340208371,-34.43948659791629,-181.8320883049373,-209.97457816613425,0.0710977913241324,28200875594.0,1
1345,2015-07-21,3939.9,4041.82,3912.8,4017.68,504288028.0,25.56999999999971,0.0,25.56999999999971,53.88842009139858,3373.54,4080.39,91.12824503077032,-8.871754969229688,-161.70446342109744,-200.3205552171269,0.1455552735951002,28705163622.0,1
1346,2015-07-22,3996.43,4042.34,3960.86,4026.04,520732225.0,8.360000000000127,0.0,8.360000000000127,54.4763242242856,3373.54,4042.34,97.56279904306216,-2.4372009569378257,-143.4252762508968,-188.94149942388088,0.0853819962095581,29225895847.0,1
1347,2015-07-23,4022.27,4132.61,4019.04,4123.92,563585966.0,97.88000000000012,0.0,97.88000000000012,61.16520056620756,3373.54,4132.61,98.8551780468205,-1.1448219531794963,-119.66140851070077,-175.08548124124488,0.0634689772551446,29789481813.0,1
1348,2015-07-24,4124.75,4184.45,4044.83,4070.91,627424860.0,-53.01000000000022,53.01000000000022,0.0,56.02142785976949,3373.54,4184.45,85.99844619008275,-14.001553809917253,-103.90804878820244,-160.8499947506364,0.0253174121433914,29162056953.0,0
1349,2015-07-27,3985.57,4051.16,3720.44,3725.56,556003247.0,-345.3499999999999,345.3499999999999,0.0,34.32349282778523,3373.54,4184.45,43.41048945012394,-56.58951054987605,-117.93082337840224,-152.26616047618958,-0.0506893889397093,28606053706.0,0
1350,2015-07-28,3573.14,3762.53,3537.36,3663.0,563330042.0,-62.559999999999945,62.559999999999945,0.0,31.752902621114146,3373.54,4184.45,35.69569989271314,-64.30430010728686,-132.56392799034347,-148.32571397902038,-0.0374963869984495,28042723664.0,0
1351,2015-07-29,3689.82,3792.07,3612.06,3789.17,434352085.0,126.17000000000009,0.0,126.17000000000009,41.88177271765496,3537.36,4184.45,38.91421595141326,-61.085784048586746,-132.45306775194558,-145.15118473360542,-0.0088957360103368,28477075749.0,1
1352,2015-07-30,3773.79,3844.37,3685.96,3705.77,457943228.0,-83.40000000000009,83.40000000000009,0.0,37.622968024348765,3537.36,4184.45,26.02574603223662,-73.97425396776339,-137.5097662232647,-143.62290103153728,-0.063572845464768,28019132521.0,0
1353,2015-07-31,3655.67,3729.51,3620.17,3663.73,350955745.0,-42.03999999999997,42.03999999999997,0.0,35.52206760254445,3537.36,4184.45,19.528968149716416,-80.47103185028358,-143.25812239055767,-143.54994530334136,-0.082257252430419,27668176776.0,0
1354,2015-08-03,3614.99,3648.94,3549.5,3622.91,363968731.0,-40.82000000000016,40.82000000000016,0.0,33.43058348367366,3537.36,4184.45,13.22072663771651,-86.77927336228349,-149.385545343388,-144.7170653113507,-0.0982581987614742,27304208045.0,0
1355,2015-08-04,3621.85,3757.03,3601.29,3756.54,362901666.0,133.6300000000001,0.0,133.6300000000001,45.54204465139147,3537.36,4184.45,33.87164073003754,-66.12835926996246,-141.82389044496767,-144.1384303380741,-0.0669392256410765,27667109711.0,1
1356,2015-08-05,3745.65,3782.35,3676.39,3694.57,366422979.0,-61.9699999999998,61.9699999999998,0.0,41.50174494245266,3537.36,4184.45,24.29492033565657,-75.70507966434343,-139.22676606079267,-143.1560974826178,-0.1041121069273894,27300686732.0,0
1357,2015-08-06,3625.5,3710.57,3614.74,3661.54,274074663.0,-33.0300000000002,33.0300000000002,0.0,39.354552264363285,3537.36,4184.45,19.190529910831557,-80.80947008916844,-138.24022398133002,-142.17292278236025,-0.1005598256900791,27026612069.0,0
1358,2015-08-07,3692.61,3756.74,3686.3,3744.21,340757184.0,82.67000000000007,0.0,82.67000000000007,47.23795243329,3537.36,4184.45,31.96618708371324,-68.03381291628676,-129.29714715005548,-139.5977676558993,0.0050059588357187,27367369253.0,1
1359,2015-08-10,3786.03,3943.62,3775.85,3928.42,497304319.0,184.21000000000004,0.0,184.21000000000004,60.45467300633895,3537.36,4184.45,60.43363365219678,-39.566366347803225,-106.12217644577912,-132.90264941387528,0.0724597324597324,27864673572.0,1
1360,2015-08-11,3928.81,3970.34,3891.18,3927.91,538923460.0,-0.5100000000002183,0.5100000000002183,0.0,60.40633492215633,3537.36,4184.45,60.354819267798895,-39.6451807322011,-86.79646234475649,-123.68141200005152,0.0366148787201419,27325750112.0,0
1361,2015-08-12,3881.23,3937.77,3871.14,3886.32,442688278.0,-41.58999999999969,41.58999999999969,0.0,56.17960145842942,3537.36,4184.45,53.92758348915919,-46.07241651084081,-73.98382067193597,-113.7418937344284,0.0487213183764778,26883061834.0,0
1362,2015-08-13,3869.91,3955.79,3838.16,3954.56,430073303.0,68.23999999999978,0.0,68.23999999999978,61.30549597603252,3537.36,4051.16,81.19891008174388,-18.80108991825612,-57.65865901178313,-102.52524678989934,0.0793808495713384,27313135137.0,1
1363,2015-08-14,3976.41,4000.68,3939.83,3965.33,467988217.0,10.769999999999982,0.0,10.769999999999982,62.11256947427308,3537.36,4000.68,92.37028403695072,-7.629715963049281,-43.35206615540392,-90.69061066300029,0.0945151825466268,27781123354.0,1
1364,2015-08-17,3947.84,3994.54,3907.4,3993.67,460432060.0,28.340000000000146,0.0,28.340000000000146,64.36900926668685,3549.5,4000.68,98.44629637838564,-1.5537036216143814,-29.38841572769479,-78.43017167593918,0.0631245774036746,28241555414.0,1
1365,2015-08-18,3999.13,4006.34,3743.39,3748.16,543770822.0,-245.51000000000025,245.51000000000025,0.0,40.34881108057754,3549.5,4006.34,43.48568426582607,-56.514315734173934,-37.69816635296365,-70.28377061134408,0.0145050709554832,27697784592.0,0
1366,2015-08-19,3646.8,3811.43,3558.38,3794.11,475396239.0,45.95000000000027,0.0,45.95000000000027,44.79741189808999,3549.5,4006.34,53.543910340600654,-46.45608965939934,-40.11351893569008,-64.24972027621328,0.0362060772243373,28173180831.0,1
1367,2015-08-20,3754.57,3788.0,3663.61,3664.29,390063057.0,-129.82000000000016,129.82000000000016,0.0,36.03647370949655,3549.5,4006.34,25.12695911041063,-74.87304088958938,-51.90476646989828,-61.78072951495028,-0.0213449566130105,27783117774.0,0
1368,2015-08-21,3609.96,3652.84,3490.54,3507.74,369920479.0,-156.55000000000018,156.55000000000018,0.0,28.32793603593022,3490.54,4006.34,3.33462582396274,-96.66537417603726,-73.03973514803965,-64.03253064156816,-0.1070863095086575,27413197295.0,0
1369,2015-08-24,3373.48,3388.36,3191.88,3209.91,334671792.0,-297.8299999999999,297.8299999999999,0.0,19.27644774862668,3191.88,4006.34,2.213736708985063,-97.78626329101496,-112.52462815629224,-73.73095014451297,-0.1827944122955974,27078525503.0,0
1370,2015-08-25,3004.13,3123.03,2947.94,2964.97,352325110.0,-244.94000000000003,244.94000000000003,0.0,14.791507373070177,2947.94,4006.34,1.6090325018896203,-98.39096749811038,-161.71712691596304,-91.328185498803,-0.2370751765166019,26726200393.0,0
1371,2015-08-26,2980.79,3092.04,2850.71,2927.29,466699663.0,-37.67999999999984,37.67999999999984,0.0,14.204874810115342,2850.71,4006.34,6.62668847295414,-93.37331152704589,-201.4211401673747,-113.34677643251734,-0.2597684698171225,26259500730.0,0
1372,2015-08-27,2978.03,3085.42,2906.49,3083.59,400308398.0,156.30000000000018,0.0,156.30000000000018,27.8925544831785,2850.71,4006.34,20.151778683488665,-79.84822131651134,-217.7644993795361,-134.2303210219211,-0.2223623254558888,26659809128.0,1
1373,2015-08-28,3125.26,3235.84,3102.95,3232.35,443136928.0,148.75999999999976,0.0,148.75999999999976,38.64257818569983,2850.71,4006.34,33.024410927372934,-66.97558907262706,-216.22058423943963,-150.62837366542482,-0.1906316746250942,27102946056.0,1
1374,2015-08-31,3203.56,3207.86,3109.16,3205.99,397431382.0,-26.360000000000127,26.360000000000127,0.0,37.49953577177936,2850.71,4006.34,30.743404030701843,-69.25659596929815,-214.64970389617972,-163.4326397115758,-0.1446496414240587,26705514674.0,0
1375,2015-09-01,3157.83,3180.33,3053.74,3166.62,432432468.0,-39.36999999999989,39.36999999999989,0.0,35.68068387739376,2850.71,4006.34,27.33660427645525,-72.66339572354474,-214.11343349737308,-173.56879846873528,-0.1653852945750124,26273082206.0,0
1376,2015-09-02,3027.68,3194.49,3019.09,3160.17,438170153.0,-6.449999999999818,6.449999999999818,0.0,35.356506282366254,2850.71,4006.34,26.778467156442808,-73.22153284355718,-211.7677694128679,-181.2085926575618,-0.1375764472790089,25834912053.0,0
1377,2015-09-07,3149.38,3217.58,3066.3,3080.42,296468114.0,-79.75,79.75,0.0,31.29949644560483,2850.71,4006.34,19.87746943225773,-80.12253056774227,-213.87851385477504,-187.74257689700448,-0.121822027858393,25538443939.0,0
1378,2015-09-08,3054.44,3174.71,3011.12,3170.45,255415465.0,90.02999999999975,0.0,90.02999999999975,40.23265684980215,2850.71,4006.34,27.668025232989773,-72.33197476701022,-205.9129886869846,-191.37665925500053,-0.0122931795595515,25793859404.0,1
1379,2015-09-09,3182.55,3256.74,3165.7,3243.09,375327978.0,72.64000000000033,0.0,72.64000000000033,46.68650652590671,2850.71,3811.43,40.84228495295197,-59.15771504704803,-191.530961975046,-191.4075197990097,0.0938019608967377,26169187382.0,1
1380,2015-09-10,3190.55,3243.28,3178.9,3197.89,273261759.0,-45.20000000000027,45.20000000000027,0.0,43.32736947109925,2850.71,3788.0,37.04083047936069,-62.9591695206393,-181.68600130928095,-189.46321610106395,0.0924404483327583,25895925623.0,0
1381,2015-09-11,3189.48,3223.76,3163.45,3200.23,224557822.0,2.340000000000145,0.0,2.340000000000145,43.56990338165419,2850.71,3652.84,43.5739842668894,-56.4260157331106,-171.71555063030064,-185.9136830069113,0.0378260404269048,26120483445.0,1
1382,2015-09-14,3221.17,3229.48,3049.23,3114.8,346631158.0,-85.42999999999984,85.42999999999984,0.0,36.91496531316485,2850.71,3388.36,49.11931553984936,-50.88068446015064,-168.7620003760535,-182.48334648073973,-0.0363667300880163,25773852287.0,0
1383,2015-09-15,3043.8,3081.7,2983.92,3005.17,249194445.0,-109.63000000000012,109.63000000000012,0.0,30.106047675126604,2850.71,3256.74,38.04152402531836,-61.95847597468164,-173.27016470248554,-180.64071012508893,-0.0626389976263182,25524657842.0,0
1384,2015-09-16,2998.04,3182.93,2983.53,3152.26,277524524.0,147.09000000000017,0.0,147.09000000000017,45.63095347328916,2850.71,3256.74,74.26791123808594,-25.732088761914053,-163.09393829496048,-177.13135575906327,-0.0045348036707908,25802182366.0,1
1385,2015-09-17,3131.98,3204.7,3085.31,3086.06,317602892.0,-66.20000000000027,66.20000000000027,0.0,40.91183304001558,2906.49,3256.74,51.26909350463959,-48.73090649536041,-158.54340263897984,-173.4137651350466,-0.0234512700266125,25484579474.0,0
1386,2015-09-18,3100.28,3122.05,3070.34,3097.92,209175398.0,11.860000000000127,0.0,11.860000000000127,42.14860591713317,2983.53,3256.74,41.86889206105195,-58.13110793894805,-152.2253088613429,-169.17607388030586,0.005681043494069,25693754872.0,1
1387,2015-09-21,3072.09,3159.88,3060.86,3156.54,239897354.0,58.61999999999989,0.0,58.61999999999989,48.31793992200144,2983.53,3256.74,63.32491490062591,-36.6750850993741,-140.86423471805074,-163.51370604785484,-0.0043873898027093,25933652226.0,1
1388,2015-09-22,3161.32,3213.48,3152.48,3185.62,274786154.0,29.079999999999927,0.0,29.079999999999927,51.29117083588478,2983.53,3256.74,73.96874199333845,-26.031258006661535,-128.03804574859942,-156.41857398800377,-0.0177207539722918,26208438380.0,1
1389,2015-09-23,3137.72,3164.04,3104.74,3115.89,236322670.0,-69.73000000000002,69.73000000000002,0.0,44.24817605836374,2983.53,3256.74,48.44625013725701,-51.55374986274299,-122.09242139078331,-149.5533434685597,-0.0256419076328454,25972115710.0,0
1390,2015-09-24,3126.49,3151.17,3109.69,3142.69,212887723.0,26.800000000000185,0.0,26.800000000000185,47.44828443942802,2983.53,3256.74,58.25555433549288,-41.74444566450712,-113.90491032536328,-142.42365683992043,-0.0179799576905409,26185003433.0,1
1391,2015-09-25,3130.85,3149.95,3063.0,3092.35,236263871.0,-50.34000000000015,50.34000000000015,0.0,42.198634666112056,2983.53,3256.74,39.83016727059766,-60.16983272940234,-110.20785851826348,-135.98049717558905,-0.0072075253627842,25948739562.0,0
1392,2015-09-28,3085.57,3103.07,3042.31,3100.76,156727530.0,8.41000000000031,0.0,8.41000000000031,43.40565216733586,2983.53,3256.74,42.90838549101432,-57.091614508985685,-105.38449475465724,-129.86129669140269,0.0318085166562958,26105467092.0,1
1393,2015-09-29,3055.22,3068.3,3021.16,3038.14,163222673.0,-62.620000000000346,62.620000000000346,0.0,36.802932361275424,2983.53,3243.28,21.02406159768996,-78.97593840231004,-105.39987078311788,-124.96901150974573,-0.0362025975014752,25942244419.0,0
1394,2015-09-30,3052.84,3073.3,3039.74,3052.78,146642449.0,14.640000000000327,0.0,14.640000000000327,39.293992285778025,2983.53,3229.48,28.15612929457209,-71.84387070542792,-103.04291615261718,-120.58379243832005,-0.0107839769803567,26088886868.0,1
1395,2015-10-08,3156.07,3172.28,3133.13,3143.36,234276050.0,90.57999999999991,0.0,90.57999999999991,52.62530272715031,2983.53,3229.48,64.98475299857697,-35.015247001423035,-92.79626604435998,-115.02628715952802,0.0146679062080363,26323162918.0,1
1396,2015-10-09,3146.64,3192.72,3137.79,3183.15,234851445.0,39.78999999999997,0.0,39.78999999999997,57.37036889737664,2983.53,3213.48,86.81017612524464,-13.18982387475536,-80.53662546331134,-108.1283548202847,0.0084301165199871,26558014363.0,1
1397,2015-10-12,3193.54,3318.71,3188.41,3287.66,386294715.0,104.50999999999976,0.0,104.50999999999976,67.29723412615786,2983.53,3318.71,90.73632078286288,-9.26367921713712,-61.67671759538689,-98.83802737530512,0.0320314412892936,26944309078.0,1
1398,2015-10-13,3262.16,3298.63,3253.25,3293.23,297153133.0,5.570000000000164,0.0,5.570000000000164,67.75892922303645,3021.16,3318.71,91.43673332213072,-8.563266677869267,-45.75323744136813,-88.22106938851773,0.0569147177852877,27241462211.0,1
1399,2015-10-14,3280.02,3307.31,3256.25,3262.44,295077739.0,-30.789999999999964,30.789999999999964,0.0,62.16142843362746,3021.16,3318.71,81.08889262308857,-18.911107376911428,-35.212354272933226,-77.61932636540084,0.0381042991831839,26946384472.0,0
1400,2015-10-15,3255.03,3338.3,3254.39,3338.07,316283851.0,75.63000000000011,0.0,75.63000000000011,69.33992049051695,3021.16,3338.3,99.92747682411552,-0.072523175884473,-20.519384790279677,-66.19933805037661,0.0794606043947161,27262668323.0,1
1401,2015-10-16,3358.3,3393.02,3334.85,3391.35,395460575.0,53.27999999999975,0.0,53.27999999999975,73.4363400050647,3021.16,3393.02,99.5509062550422,-0.4490937449577992,-4.52370346010639,-53.86421113232256,0.0937157342070975,27658128898.0,1
1402,2015-10-19,3401.63,3423.4,3355.57,3386.7,378112183.0,-4.650000000000091,4.650000000000091,0.0,72.46140748164215,3021.16,3423.4,90.87609387430383,-9.123906125696164,7.689137507524265,-41.55354140435319,0.1147280902130909,27280016715.0,0
1403,2015-10-20,3377.55,3425.52,3357.86,3425.33,318973758.0,38.63000000000011,0.0,38.63000000000011,75.5702722027774,3021.16,3425.52,99.9530121673756,-0.0469878326244075,20.25157259603793,-29.19251860427497,0.1220363078898576,27598990473.0,1
1404,2015-10-21,3428.56,3447.26,3265.44,3320.68,458455428.0,-104.65000000000008,104.65000000000008,0.0,55.858965875710936,3021.16,3447.26,70.29335836658055,-29.70664163341945,21.51500096913469,-19.051014689593032,0.0564109742441207,27140535045.0,0
1405,2015-10-22,3292.29,3373.78,3282.99,3368.74,323739341.0,48.059999999999945,0.0,48.059999999999945,61.219090109683975,3021.16,3447.26,81.572400844872,-18.42759915512799,26.09352746122977,-10.022106259428467,0.0583038813753671,27464274386.0,1
1406,2015-10-23,3377.55,3422.02,3360.22,3412.43,347372854.0,43.690000000000055,0.0,43.690000000000055,65.60065018958494,3021.16,3447.26,91.82586247359768,-8.174137526402335,32.868572120719364,-1.4439705833989,0.0379510046659326,27811647240.0,1
1407,2015-10-26,3448.65,3457.52,3402.0,3429.58,365560853.0,17.15000000000009,0.0,17.15000000000009,67.27527223989946,3039.74,3457.52,93.31226961558714,-6.687730384412858,39.17017608902961,6.678858751086805,0.0414031209481269,28177208093.0,1
1408,2015-10-27,3409.14,3441.56,3332.62,3434.34,328172768.0,4.760000000000218,0.0,4.760000000000218,67.77763190368884,3133.13,3457.52,92.8542803415642,-7.145719658435786,44.040661521875336,14.151219305244515,0.0526906241953875,28505380861.0,1
1409,2015-10-28,3417.01,3439.76,3367.23,3375.2,293523284.0,-59.14000000000033,59.14000000000033,0.0,55.55224511151162,3137.79,3457.52,74.25327620179522,-25.746723798204783,42.63696023397051,19.84836749098972,0.0111231939414091,28211857577.0,0
1410,2015-10-29,3387.77,3411.71,3362.51,3387.31,235676026.0,12.110000000000127,0.0,12.110000000000127,57.36906471806408,3188.41,3457.52,73.9102969046115,-26.089703095388504,42.01734286898591,24.28216256658896,-0.0011912660150087,28447533603.0,1
1411,2015-10-30,3380.28,3417.2,3346.59,3382.56,243595118.0,-4.75,4.75,0.0,56.32704409757326,3253.25,3457.52,63.30347089636263,-36.69652910363737,40.67414017141664,27.560558087554497,-0.0012224289131012,28203938485.0,0
1412,2015-11-02,3337.58,3391.06,3322.31,3325.08,230951129.0,-57.48000000000002,57.48000000000002,0.0,44.931804507728735,3254.39,3457.52,34.80037414463645,-65.19962585536355,34.572951275355535,28.963036725114705,-0.0292672530821848,27972987356.0,0
1413,2015-11-03,3330.32,3346.27,3302.18,3316.7,192897428.0,-8.38000000000011,8.38000000000011,0.0,43.453030738431664,3254.39,3457.52,30.674937232314235,-69.32506276768576,28.730333749663718,28.916496130024505,-0.0011985496946408,27780089928.0,0
1414,2015-11-04,3325.62,3459.65,3325.62,3459.64,339078730.0,142.94000000000003,0.0,142.94000000000003,65.68225435366847,3265.44,3459.65,99.99485093455527,-0.0051490654447341,35.22799427797054,30.17879575961372,0.0269833825109684,28119168658.0,1
1415,2015-11-05,3459.22,3585.66,3455.52,3522.82,553254947.0,63.18000000000029,0.0,63.18000000000029,71.41350741589721,3265.44,3585.66,80.37599150583982,-19.62400849416018,44.95729532689529,33.134495673070035,0.0323493815257749,28672423605.0,1
1416,2015-11-06,3514.44,3596.38,3508.83,3590.03,429167033.0,67.21000000000004,0.0,67.21000000000004,76.27657591648897,3265.44,3596.38,98.08122318245002,-1.9187768175499813,57.42911472047581,37.99341948255119,0.0467841543279352,29101590638.0,1
1417,2015-11-09,3588.5,3673.76,3588.5,3646.88,503016682.0,56.84999999999991,0.0,56.84999999999991,79.65458322771434,3265.44,3673.76,93.4169278996865,-6.583072100313505,71.08106308045626,44.61094820213221,0.0618867089455323,29604607320.0,1
1418,2015-11-10,3617.4,3669.53,3607.89,3640.49,429746576.0,-6.390000000000327,6.390000000000327,0.0,78.21025724845833,3282.99,3673.76,91.48604038181016,-8.51395961818983,80.45724982311276,51.78020852632832,0.0785997866793077,29174860744.0,0
1419,2015-11-11,3635.0,3654.88,3605.62,3650.25,360972651.0,9.760000000000218,0.0,9.760000000000218,78.88500628955933,3302.18,3673.76,93.6729640992518,-6.327035900748208,87.66494884003077,58.95715658906882,0.0776250180821951,29535833395.0,1
1420,2015-11-12,3656.82,3659.31,3603.23,3632.9,361717600.0,-17.34999999999991,17.34999999999991,0.0,74.17373727863053,3302.18,3673.76,89.00371387049893,-10.996286129501073,90.92893013431012,65.35151129811709,0.0740090345773616,29174115795.0,0
1421,2015-11-13,3600.76,3632.56,3564.81,3580.84,345870933.0,-52.059999999999945,52.059999999999945,0.0,61.46447829745977,3302.18,3673.76,74.99327197373378,-25.00672802626621,88.29701883912367,69.94061280631841,0.076918450082404,28828244862.0,0
1422,2015-11-16,3522.46,3607.61,3519.42,3606.96,276187057.0,26.11999999999989,0.0,26.11999999999989,64.94203111395368,3302.18,3673.76,82.02271381667471,-17.97728618332529,87.31239296581134,73.414968838217,0.0875146983447403,29104431919.0,1
1423,2015-11-17,3629.98,3678.27,3598.07,3604.79,383575468.0,-2.1700000000000728,2.1700000000000728,0.0,64.38506077248084,3302.18,3678.27,80.4621234279029,-19.5378765720971,85.37284399993086,75.80654387055978,0.0419552323363123,28720856451.0,0
1424,2015-11-18,3605.06,3617.07,3558.7,3568.47,297580734.0,-36.32000000000016,36.32000000000016,0.0,55.23625439921525,3302.18,3678.27,70.80486053870081,-29.195139461299195,79.98302251384348,76.64183959921652,0.0129583685797172,28423275717.0,0
1425,2015-11-19,3573.78,3618.21,3561.04,3617.06,247915576.0,48.59000000000015,0.0,48.59000000000015,63.28870389908664,3302.18,3678.27,83.72464037863277,-16.27535962136723,78.72486582230704,77.05844484383464,0.0075291849928829,28671191293.0,1
1426,2015-11-20,3620.79,3640.53,3607.92,3630.5,310801972.0,13.440000000000056,0.0,13.440000000000056,65.28193380340127,3302.18,3678.27,87.29825307772077,-12.70174692227923,77.91411780674571,77.22957943641686,-0.0044915105514851,28981993265.0,1
1427,2015-11-23,3630.87,3654.75,3598.87,3610.31,315997474.0,-20.19000000000005,20.19000000000005,0.0,59.666619539221706,3325.62,3678.27,80.72876790018432,-19.271232099815684,74.78040790501882,76.73974513013725,-0.0082900928171756,28665995791.0,0
1428,2015-11-24,3602.89,3616.48,3563.1,3616.11,248810524.0,5.800000000000182,0.0,5.800000000000182,60.78470781278352,3455.52,3678.27,72.09427609427615,-27.90572390572384,71.93570176657113,75.77893645742402,-0.0093527840558865,28914806315.0,1
1429,2015-11-25,3614.07,3648.37,3607.52,3647.93,273024857.0,31.81999999999971,0.0,31.81999999999971,66.63895669887856,3508.83,3678.27,82.09395656279501,-17.906043437204993,71.42551089722747,74.90825134538471,0.0041371906741169,29187831172.0,1
1430,2015-11-26,3659.57,3668.38,3629.86,3635.55,306761582.0,-12.379999999999654,12.379999999999654,0.0,62.45351777844252,3519.42,3678.27,73.10670443814931,-26.89329556185069,69.224244422418,73.77144996079137,0.0152785379966711,28881069590.0,0
1431,2015-11-27,3616.54,3621.9,3412.43,3436.3,354287525.0,-199.25,199.25,0.0,28.828573811692976,3412.43,3678.27,8.979085164008552,-91.02091483599143,50.81613827352157,69.18038762333741,-0.0473140816643378,28526782065.0,0
1432,2015-11-30,3433.85,3470.37,3327.81,3445.41,304197903.0,9.109999999999673,0.0,9.109999999999673,30.794262411790243,3327.81,3678.27,33.55589796267759,-66.44410203732241,36.54145524206706,62.65260114708334,-0.0442133938454112,28830979968.0,1
1433,2015-12-01,3442.44,3483.41,3417.54,3456.31,252390755.0,10.900000000000093,0.0,10.900000000000093,33.336145090360574,3327.81,3678.27,36.66609598812988,-63.33390401187011,25.81067559928124,55.28421603752293,-0.0314308373056239,29083370723.0,1
1434,2015-12-02,3450.28,3538.85,3427.66,3536.91,301491480.0,80.59999999999991,0.0,80.59999999999991,49.24248342170648,3327.81,3678.27,59.6644410203732,-40.3355589796268,23.53886048770437,48.935144927559215,-0.022158880416692,29384862203.0,1
1435,2015-12-03,3525.73,3591.73,3517.23,3584.82,281111255.0,47.91000000000031,0.0,47.91000000000031,56.38081016203927,3327.81,3678.27,73.33504536894372,-26.66495463105627,25.312579582763192,44.21063185860002,-0.0125822889409171,29665973458.0,1
1436,2015-12-04,3558.15,3568.97,3510.41,3524.99,251736411.0,-59.83000000000038,59.83000000000038,0.0,46.88065920433151,3327.81,3678.27,56.26319694116299,-43.73680305883701,21.64101956227978,39.69670939933597,-0.0236323196623005,29414237047.0,0
1437,2015-12-07,3529.81,3543.95,3506.62,3536.93,208302579.0,11.940000000000056,0.0,11.940000000000056,48.86471158912966,3327.81,3668.38,61.40294212643504,-38.59705787356496,19.470298525578528,35.65142722458449,-0.0218964577958082,29622539626.0,1
1438,2015-12-08,3518.65,3518.65,3466.79,3470.07,224367310.0,-66.85999999999967,66.85999999999967,0.0,39.36481945966324,3327.81,3668.38,41.771148368910985,-58.228851631089015,12.21414616319862,30.963971012307315,-0.048756418023372,29398172316.0,0
1439,2015-12-09,3462.58,3495.7,3454.88,3472.44,195698845.0,2.369999999999891,0.0,2.369999999999891,39.843161136256526,3327.81,3668.38,42.46704054966675,-57.53295945033325,6.578993786254614,26.086975567096776,-0.0448652886083261,29593871161.0,1
1440,2015-12-10,3469.81,3503.65,3446.27,3455.5,200427517.0,-16.940000000000055,16.940000000000055,0.0,37.40924580807346,3327.81,3668.38,37.4930263969228,-62.5069736030772,0.7376750432217705,21.017115462321776,0.0055874050577655,29393443644.0,0
1441,2015-12-11,3441.6,3455.55,3410.92,3434.58,182908878.0,-20.920000000000076,20.920000000000076,0.0,34.41367930121909,3327.81,3668.38,31.350383181137488,-68.64961681886251,-5.516095197539471,15.710473330349526,-0.0031433124069414,29210534766.0,0
1442,2015-12-14,3403.51,3521.78,3399.28,3520.67,215374620.0,86.09000000000015,0.0,86.09000000000015,52.48137638070233,3327.81,3668.38,56.62859324074348,-43.37140675925653,-3.485332905285304,11.87131208322256,0.0186210148973906,29425909386.0,1
1443,2015-12-15,3518.13,3529.96,3496.85,3510.35,200471341.0,-10.320000000000164,10.320000000000164,0.0,50.55505384301828,3327.81,3668.38,53.59837918783212,-46.40162081216787,-2.677808797049238,8.9614879071682,-0.0075093796562536,29225438045.0,0
1444,2015-12-16,3522.09,3538.69,3506.29,3516.19,193482310.0,5.8400000000001455,0.0,5.8400000000001455,51.71234064525851,3327.81,3621.9,64.05522119079194,-35.94477880920806,-1.5487479282373895,6.859440740087082,-0.0191446153502825,29418920355.0,1
1445,2015-12-17,3533.63,3583.41,3533.63,3580.0,283856476.0,63.809999999999945,0.0,63.809999999999945,62.714596570497065,3327.81,3591.73,95.55547135495604,-4.444528645043958,4.443749879843381,6.376302568038342,0.0156057180304058,29702776831.0,1
1446,2015-12-18,3574.94,3614.7,3568.16,3578.96,273707904.0,-1.0399999999999636,1.0399999999999636,0.0,62.447018941531134,3399.28,3614.7,83.4091542103798,-16.590845789620204,9.00512280777184,6.902066615985043,0.0118831868315176,29429068927.0,0
1447,2015-12-21,3568.58,3651.06,3565.75,3642.47,299849280.0,63.50999999999976,0.0,63.50999999999976,71.1271687554571,3399.28,3651.06,96.58829136547774,-3.411708634522263,17.54255034039079,9.030163360866194,0.0496819948877111,29728918207.0,1
1448,2015-12-22,3645.99,3652.64,3616.87,3651.77,261178763.0,9.300000000000182,0.0,9.300000000000182,72.2124007093923,3399.28,3652.64,99.65661509314812,-0.3433849068518677,24.773383303663195,12.178807349425597,0.0516438009008075,29990096970.0,1
1449,2015-12-23,3653.28,3684.57,3633.02,3636.09,298201801.0,-15.679999999999836,15.679999999999836,0.0,67.29192418865212,3399.28,3684.57,83.00676504609345,-16.993234953906562,28.90542185547247,15.524130250634972,0.0522616119230212,29691895169.0,0
1450,2015-12-24,3631.31,3640.22,3572.28,3612.49,227785225.0,-23.600000000000364,23.600000000000364,0.0,60.171584987162646,3399.28,3684.57,74.73448070384508,-25.265519296154928,29.930746397711573,18.40545348005029,0.0517996378014196,29464109944.0,0
1451,2015-12-25,3614.05,3635.26,3601.74,3627.91,198451111.0,15.420000000000073,0.0,15.420000000000073,63.11409818624509,3399.28,3684.57,80.13950716814459,-19.860492831855417,31.623057689805137,21.048974322001264,0.0304601112856359,29662561055.0,1
1452,2015-12-28,3635.77,3641.59,3533.78,3533.78,269983278.0,-94.12999999999964,94.12999999999964,0.0,41.51217308393538,3399.28,3684.57,47.14501034035544,-52.854989659644566,25.079620010507824,21.85510345970258,0.0066745481219823,29392577777.0,0
1453,2015-12-29,3528.4,3564.17,3515.52,3563.74,182551923.0,29.95999999999958,0.0,29.95999999999958,48.04304842382313,3399.28,3684.57,57.64660520873483,-42.35339479126517,22.05715892261924,21.895514552285917,0.0135231600112621,29575129700.0,1
1454,2015-12-30,3566.73,3573.68,3538.11,3572.88,187889609.0,9.140000000000327,0.0,9.140000000000327,50.00802987013883,3399.28,3684.57,60.85036278874125,-39.14963721125874,20.16688702843157,21.54978904751505,-0.0019888268156423,29763019309.0,1
1455,2015-12-31,3570.47,3580.6,3538.35,3539.18,176963659.0,-33.70000000000027,33.70000000000027,0.0,43.07708133601039,3399.28,3684.57,49.037821164429054,-50.96217883557095,15.76776361243401,20.39338396049884,-0.0111149607707267,29586055650.0,0
1456,2016-01-04,3536.59,3538.69,3295.74,3296.66,184418423.0,-242.52,242.52,0.0,20.02793938768356,3295.74,3684.57,0.2366072576704657,-99.76339274232954,-7.204857452662964,14.87373567786648,-0.0949383248180493,29401637227.0,0
1457,2016-01-05,3196.65,3328.14,3189.6,3287.71,266882083.0,-8.949999999999818,8.949999999999818,0.0,19.58178602021593,3189.6,3684.57,19.821403317372784,-80.17859668262722,-25.83520321645574,6.731947899002034,-0.0996941209331365,29134755144.0,0
1458,2016-01-06,3291.19,3362.97,3288.93,3361.84,238886670.0,74.13000000000011,0.0,74.13000000000011,33.697334735400176,3189.6,3684.57,34.798068569812344,-65.20193143018766,-34.22370541639066,-1.4591827640765074,-0.0754244256880329,29373641814.0,1
1459,2016-01-07,3309.66,3309.66,3115.89,3125.0,70569123.0,-236.84000000000012,236.84000000000012,0.0,20.45893809670312,3115.89,3684.57,1.6019554055004788,-98.39804459449952,-59.29909938595392,-13.027166088451994,-0.1349457022718401,29303072691.0,0
1460,2016-01-08,3194.63,3235.45,3056.88,3186.41,286440822.0,61.409999999999854,0.0,61.409999999999854,28.824624070788676,3056.88,3684.57,20.63598273032862,-79.36401726967136,-73.37048669104252,-25.095830208970103,-0.12169541140767,29589513513.0,1
1461,2016-01-11,3131.85,3166.22,3016.7,3016.7,271643691.0,-169.71000000000004,169.71000000000004,0.0,21.58546867697042,3016.7,3684.57,0.0,-100.0,-97.09706664014492,-39.49607749520508,-0.1463248985505607,29317869822.0,0
1462,2016-01-12,3026.16,3047.66,2978.46,3022.86,207659622.0,6.160000000000309,0.0,6.160000000000309,22.40167095433543,2978.46,3684.57,6.287972128988413,-93.7120278710116,-114.08835216562238,-54.41453242928856,-0.1517731372097851,29525529444.0,1
1463,2016-01-13,3041.11,3059.01,2949.29,2949.6,194282106.0,-73.26000000000022,73.26000000000022,0.0,19.60183780385813,2949.29,3641.59,0.0447782753141622,-99.95522172468584,-131.9445633076275,-69.92053860495635,-0.1744475045341573,29331247338.0,0
1464,2016-01-14,2874.05,3012.29,2867.55,3007.65,212905644.0,58.05000000000018,0.0,58.05000000000018,27.84683206780032,2867.55,3641.59,18.099839801560638,-81.90016019843937,-139.80006134415407,-83.8964431527959,-0.1501845060155177,29544152982.0,1
1465,2016-01-15,2988.05,3001.71,2883.87,2900.97,198721697.0,-106.68000000000028,106.68000000000028,0.0,22.872953547233323,2867.55,3641.59,4.317606325254459,-95.68239367474554,-152.87157620075868,-97.69146976238846,-0.1200275430283984,29345431285.0,0
1466,2016-01-18,2847.54,2945.45,2844.7,2913.84,164699694.0,12.870000000000346,0.0,12.870000000000346,24.74408149528112,2844.7,3580.6,9.395298274222084,-90.60470172577791,-160.34399865307614,-110.22197554052602,-0.1137174507483932,29510130979.0,1
1467,2016-01-19,2914.41,3012.07,2906.4,3007.74,205279703.0,93.89999999999964,0.0,93.89999999999964,37.50732005085733,2844.7,3580.6,22.15518412827829,-77.8448158717217,-156.8805803618361,-119.55369650478804,-0.1053292244723128,29715410682.0,1
1468,2016-01-20,2993.01,3016.28,2951.92,2976.69,216505474.0,-31.049999999999727,31.049999999999727,0.0,35.227769187054136,2844.7,3580.6,17.935860850659086,-82.0641391493409,-154.85618619791012,-126.61419444341249,-0.0474592,29498905208.0,0
1469,2016-01-21,2934.39,2998.79,2880.08,2880.48,191675668.0,-96.21000000000004,96.21000000000004,0.0,28.939503944470232,2844.7,3538.69,5.155693886079077,-94.84430611392092,-159.18025132648154,-133.1274058200263,-0.0960108711684936,29307229540.0,0
1470,2016-01-22,2911.11,2931.36,2851.73,2916.56,159810734.0,36.07999999999993,0.0,36.07999999999993,34.03464089773472,2844.7,3362.97,13.865359754568107,-86.1346402454319,-157.87585504457593,-138.07709566493622,-0.03319521331256,29467040274.0,1
1471,2016-01-25,2934.08,2955.78,2911.83,2938.51,153039057.0,21.950000000000276,0.0,21.950000000000276,37.1957020312438,2844.7,3362.97,18.10060393231335,-81.89939606768665,-153.3037399514069,-141.12242452223038,-0.0279040378978847,29620079331.0,1
1472,2016-01-26,2907.72,2911.99,2743.84,2749.79,210836054.0,-188.72000000000023,188.72000000000023,0.0,25.210792278026915,2743.84,3309.66,1.0515711710437632,-98.94842882895624,-163.02913422369463,-145.50376646252323,-0.0677413886628695,29409243277.0,0
1473,2016-01-27,2756.08,2768.77,2638.3,2735.56,215722046.0,-14.230000000000018,14.230000000000018,0.0,24.523318518494364,2638.3,3235.45,16.287364983672415,-83.71263501632758,-169.92601994444703,-150.388217158908,-0.0904659784216913,29193521231.0,0
1474,2016-01-28,2711.16,2740.54,2647.49,2655.66,171120280.0,-79.90000000000009,79.90000000000009,0.0,20.841312575987917,2638.3,3166.22,3.288377026822186,-96.7116229731778,-179.7668732020802,-156.26394836754244,-0.0845613708518184,29022400951.0,0
1475,2016-01-29,2652.85,2755.37,2649.79,2737.6,186673106.0,81.94000000000005,0.0,81.94000000000005,32.783367962070386,2638.3,3059.01,23.60295690618234,-76.39704309381766,-178.89179386601427,-160.7895174672368,-0.0604837602613733,29209074057.0,1
1476,2016-02-01,2730.98,2735.26,2655.62,2688.85,156383744.0,-48.75,48.75,0.0,29.706822960969504,2638.3,3059.01,12.015402533811825,-87.98459746618818,-180.05642636492576,-164.64289924677462,-0.1060231269990091,29052690313.0,0
1477,2016-02-02,2687.98,2755.16,2687.98,2749.57,158078211.0,60.720000000000255,0.0,60.720000000000255,38.06058080548293,2638.3,3016.28,29.43806550611143,-70.56193449388857,-174.07320195393095,-166.5289597882059,-0.0762995138895887,29210768524.0,1
1478,2016-02-03,2719.57,2746.07,2696.88,2739.25,148397217.0,-10.320000000000164,10.320000000000164,0.0,37.19374964646975,2638.3,3016.28,26.707762315466372,-73.29223768453362,-168.22499819085624,-166.86816746873598,-0.0490300227739821,29062371307.0,0
1479,2016-02-04,2751.43,2793.3,2751.31,2781.02,170382018.0,41.76999999999998,0.0,41.76999999999998,43.23180227253247,2638.3,3016.28,37.75861156674951,-62.24138843325049,-158.39389839709793,-165.1733136544084,-0.0464725567106454,29232753325.0,1
1480,2016-02-05,2783.08,2790.06,2762.16,2763.49,141186284.0,-17.5300000000002,17.5300000000002,0.0,41.30870625286855,2638.3,3016.28,33.120800042330174,-66.87919995766983,-150.28481567096742,-162.1956140577202,-0.0595607978193031,29091567041.0,0
1481,2016-02-15,2684.96,2760.36,2682.09,2746.2,129263932.0,-17.289999999999964,17.289999999999964,0.0,39.318249325019934,2638.3,3016.28,28.54648394094916,-71.45351605905084,-143.5981575160672,-158.47612274938962,-0.001305554242324,28962303109.0,0
1482,2016-02-16,2758.58,2840.62,2758.58,2836.57,195961614.0,90.37000000000036,0.0,90.37000000000036,52.98157606017373,2638.3,2998.79,55.00013870010266,-44.99986129989733,-129.51387369082022,-152.68367293767574,0.036924797847607,29158264723.0,1
1483,2016-02-17,2829.76,2868.7,2824.36,2867.34,216909925.0,30.769999999999985,0.0,30.769999999999985,56.80282085670633,2638.3,2955.78,72.14312712611817,-27.856872873881837,-114.54864991103022,-145.05666833234665,0.0797089988929307,29375174648.0,1
1484,2016-02-18,2881.78,2893.21,2857.7,2862.89,219203873.0,-4.450000000000273,4.450000000000273,0.0,56.04278009346832,2638.3,2955.78,70.74146402923009,-29.258535970769916,-101.87334752047082,-136.4200041699715,0.0457663646990065,29155970775.0,0
1485,2016-02-19,2854.9,2872.72,2840.49,2860.02,163391413.0,-2.869999999999891,2.869999999999891,0.0,55.49025312527163,2638.3,2911.99,81.01136322116268,-18.988636778837325,-91.0105510888875,-127.3381135537547,0.0636591851535042,28992579362.0,0
1486,2016-02-22,2888.6,2933.96,2880.35,2927.18,232176042.0,67.15999999999985,0.0,67.15999999999985,64.8478171179133,2638.3,2933.96,97.70682540756268,-2.293174592437328,-76.10516298905668,-117.0915234408151,0.0645955549413179,29224755404.0,1
1487,2016-02-23,2925.71,2928.05,2872.28,2903.33,199740663.0,-23.84999999999991,23.84999999999991,0.0,59.70453219315758,2647.49,2933.96,89.30778091946799,-10.692219080532022,-65.4624211673763,-106.76570298612734,0.059899607556813,29025014741.0,0
1488,2016-02-24,2889.88,2929.87,2872.27,2928.9,213410384.0,25.570000000000164,0.0,25.570000000000164,63.30487493130054,2649.79,2933.96,98.21937572579796,-1.7806242742020424,-54.338308102898736,-96.2802240094816,0.05317473444995,29238425125.0,1
1489,2016-02-25,2922.24,2922.24,2729.85,2741.25,270284416.0,-187.6500000000001,187.6500000000001,0.0,36.03876107694643,2655.62,2933.96,30.764532586045867,-69.23546741395413,-59.97282569508389,-89.01874434660208,-0.0080477946364921,28968140709.0,0
1490,2016-02-26,2760.06,2784.75,2715.87,2767.21,191110472.0,25.96000000000004,0.0,25.96000000000004,40.153381092852165,2682.09,2933.96,33.79521181561914,-66.20478818438086,-61.63299958417383,-83.54159539411643,0.0076505716990751,29159251181.0,1
1491,2016-02-29,2754.81,2755.89,2638.96,2687.98,207410709.0,-79.23000000000002,79.23000000000002,0.0,32.737103279505504,2638.96,2933.96,16.616949152542368,-83.38305084745762,-68.55167713734545,-80.54361174276224,-0.0523836887508505,28951840472.0,0
1492,2016-03-01,2688.38,2747.56,2668.76,2733.17,187207443.0,45.190000000000055,0.0,45.190000000000055,40.02698293750043,2638.96,2933.96,31.935593220339,-68.064406779661,-69.58617747515882,-78.35212488924157,-0.0467924975761507,29139047915.0,1
1493,2016-03-02,2733.77,2852.7,2732.54,2849.68,270961783.0,116.50999999999976,0.0,116.50999999999976,54.648825386864736,2638.96,2933.96,71.4305084745762,-28.5694915254238,-60.309433552076825,-74.74358662180862,-0.0046142184994882,29410009698.0,1
1494,2016-03-03,2847.33,2878.45,2840.87,2859.76,287478210.0,10.080000000000382,0.0,10.080000000000382,55.72637317402618,2638.96,2933.96,74.8474576271187,-25.15254237288129,-51.54993978268658,-70.1048572539842,-9.090845518555656e-05,29697487908.0,1
1495,2016-03-04,2848.54,2880.37,2808.85,2874.15,312495169.0,14.389999999999873,0.0,14.389999999999873,57.39388197257782,2638.96,2933.96,79.72542372881358,-20.274576271186422,-42.95170460971531,-64.67422672513042,-0.0181164123832493,30009983077.0,1
1496,2016-03-07,2886.64,2911.84,2871.35,2897.34,217466836.0,23.19000000000005,0.0,23.19000000000005,60.182475118278006,2638.96,2933.96,87.58644067796614,-12.41355932203386,-33.87580292593793,-58.514541965291926,-0.0020631481781264,30227449913.0,1
1497,2016-03-08,2895.67,2902.62,2802.56,2901.39,233482661.0,4.049999999999727,0.0,4.049999999999727,60.70079649346873,2638.96,2933.96,88.95932203389825,-11.04067796610175,-26.055927784220785,-52.022819129077696,-0.009392604732152,30460932574.0,1
1498,2016-03-09,2839.41,2863.01,2811.72,2862.56,183355383.0,-38.82999999999993,38.82999999999993,0.0,53.05978859746131,2638.96,2933.96,75.7966101694915,-24.203389830508502,-22.72986118846893,-46.16422754095595,0.0442535339717282,30277577191.0,0
1499,2016-03-10,2847.57,2863.18,2803.48,2804.73,138979461.0,-57.82999999999993,57.82999999999993,0.0,43.62333459199216,2638.96,2933.96,56.19322033898304,-43.80677966101696,-24.47815817255514,-41.82701366727579,0.0135587830341752,30138597730.0,0
1500,2016-03-11,2781.6,2815.61,2772.55,2810.31,127247554.0,5.579999999999927,0.0,5.579999999999927,44.717937167653886,2638.96,2929.87,58.9013784331924,-41.09862156680761,-25.123824947294,-38.48637592327944,0.0455100112352027,30265845284.0,1
1501,2016-03-14,2830.08,2889.82,2823.03,2859.5,194816030.0,49.190000000000055,0.0,49.190000000000055,53.83509648395911,2638.96,2929.87,75.81038809253724,-24.18961190746276,-21.419389230098204,-35.072978584643195,0.0462210546727792,30460661314.0,1
1502,2016-03-15,2853.98,2865.79,2819.79,2864.37,163386667.0,4.869999999999891,0.0,4.869999999999891,54.6887495346943,2638.96,2922.24,79.57144874329288,-20.428551256707124,-17.884467921980104,-31.635276452110578,0.005154964767974,30624047981.0,1
1503,2016-03-16,2858.71,2881.53,2854.19,2870.43,186492535.0,6.059999999999945,0.0,6.059999999999945,55.86064011886289,2638.96,2911.84,84.8248314277337,-15.175168572266305,-14.427712276908096,-28.193763617070083,0.0037310823285869,30810540516.0,1
1504,2016-03-17,2875.41,2921.0,2857.19,2904.83,200290213.0,34.40000000000009,0.0,34.40000000000009,62.25471164126539,2638.96,2921.0,94.2667706708268,-5.733229329173193,-8.810850021915485,-24.31718089803916,0.0106744602752117,31010830729.0,1
1505,2016-03-18,2915.52,2971.55,2908.74,2955.15,313332735.0,50.32000000000016,0.0,50.32000000000016,69.67035565610301,2668.76,2971.55,94.5837048779682,-5.416295122031802,-0.2956348646198421,-19.5128716913553,0.0199527842779929,31324163464.0,1
1506,2016-03-21,2978.46,3028.32,2973.76,3018.8,352400438.0,63.65000000000009,0.0,63.65000000000009,76.42912363847569,2732.54,3028.32,96.78139157481912,-3.2186084251808698,11.456691937985852,-13.318958965487068,0.0404668107355441,31676563902.0,1
1507,2016-03-22,3001.63,3019.1,2988.43,2999.36,270377322.0,-19.44000000000005,19.44000000000005,0.0,70.86403771819363,2772.55,3028.32,88.6773272862337,-11.32267271376629,18.98302556466615,-6.858562059456425,0.0477893913140685,31406186580.0,0
1508,2016-03-23,2991.17,3012.56,2980.86,3009.96,216977462.0,10.599999999999907,0.0,10.599999999999907,72.1403196883033,2772.55,3028.32,92.82167572428348,-7.178324275716514,25.508978969448435,-0.3850538536754507,0.0731728187739997,31623164042.0,1
1509,2016-03-24,2986.8,2998.15,2960.54,2960.97,237006403.0,-48.99000000000024,48.99000000000024,0.0,58.47966215911203,2772.55,3028.32,73.66774836767394,-26.332251632326063,26.42317062311531,4.976591041682704,0.0536097441207552,31386157639.0,0
1510,2016-03-25,2956.2,2981.41,2952.11,2979.43,175074344.0,18.46000000000004,0.0,18.46000000000004,61.63805618908536,2772.55,3028.32,80.88517027016448,-19.114829729835527,28.310891484271902,9.643451130200546,0.0419408987585241,31561231983.0,1
1511,2016-03-28,2988.01,3008.17,2948.53,2957.82,202021241.0,-21.609999999999676,21.609999999999676,0.0,55.89492440898036,2772.55,3028.32,72.43617312429136,-27.56382687570865,27.74336917908977,13.263434739978392,0.0326249751254204,31359210742.0,0
1512,2016-03-29,2956.71,2962.2,2905.25,2919.83,182965345.0,-37.99000000000024,37.99000000000024,0.0,47.01002074188311,2772.55,3028.32,57.58298471282784,-42.41701528717216,23.952024134527164,15.401152618888148,0.0172099650575001,31176245397.0,0
1513,2016-03-30,2941.22,3001.11,2941.22,3000.65,210371451.0,80.82000000000016,0.0,80.82000000000016,61.88296426630412,2772.55,3028.32,89.181686671619,-10.818313328380995,27.1558190524961,17.75208590560974,0.0329864398260828,31386616848.0,1
1514,2016-03-31,3009.37,3023.41,2992.92,3003.92,220413445.0,3.269999999999982,0.0,3.269999999999982,62.375962531289545,2819.79,3028.32,88.29904570085836,-11.700954299141642,29.617301463411422,20.12512901717008,0.0165033923827893,31607030293.0,1
1515,2016-04-01,2997.09,3009.67,2956.25,3009.53,206545866.0,5.610000000000127,0.0,5.610000000000127,63.31520007001865,2819.79,3028.32,90.9893060950463,-9.010693904953698,31.65581558634085,22.431266331004235,-0.0030707565920232,31813576159.0,1
1516,2016-04-05,3000.94,3057.33,2993.15,3053.07,256730344.0,43.53999999999997,0.0,43.53999999999997,70.01784683351104,2854.19,3057.33,97.90292409175947,-2.097075908240507,36.365468354033965,25.218106735610185,0.0179071535260855,32070306503.0,1
1517,2016-04-06,3039.74,3059.79,3029.0,3050.59,232262051.0,-2.480000000000018,2.480000000000018,0.0,69.18704750266012,2857.19,3059.79,95.45903257650552,-4.540967423494483,39.44311119648273,28.0631076277847,0.0134985182527342,31838044452.0,0
1518,2016-04-07,3058.34,3062.36,3007.06,3008.42,220919506.0,-42.17000000000007,42.17000000000007,0.0,56.12177159090968,2905.25,3062.36,65.6673668130609,-34.33263318693909,38.04088708505151,30.058663519238063,0.0160251539191549,31617124946.0,0
1519,2016-04-08,2988.2,2996.17,2960.46,2984.96,187904633.0,-23.46000000000004,23.46000000000004,0.0,50.05430321615295,2905.25,3062.36,50.73515371395836,-49.264846286041646,34.63731107654985,30.974393030700423,0.0018560597161203,31429220313.0,0
1520,2016-04-11,3006.91,3048.98,3006.91,3033.96,220018324.0,49.0,0.0,49.0,60.37787330761632,2905.25,3062.36,81.92349309401052,-18.07650690598948,35.48479641374615,31.87647370730957,0.0257419315577012,31649238637.0,1
1521,2016-04-12,3031.3,3036.82,3001.32,3023.65,182718668.0,-10.309999999999944,10.309999999999944,0.0,57.49280674443044,2905.25,3062.36,75.36121188975876,-24.63878811024124,34.92194536552415,32.485568038952486,0.0355568646119808,31466519969.0,0
1522,2016-04-13,3041.36,3097.16,3041.36,3066.64,310003246.0,42.98999999999978,0.0,42.98999999999978,65.43843306279064,2905.25,3097.16,84.09671200041686,-15.90328799958314,37.51239602158376,33.49093363547874,0.0219919017546197,31776523215.0,1
1523,2016-04-14,3080.09,3086.7,3056.99,3082.36,208237830.0,15.720000000000256,0.0,15.720000000000256,67.96496025821335,2905.25,3097.16,92.2880516908969,-7.711948309103089,40.36847678035883,34.86644226445476,0.0261125462728701,31984761045.0,1
1524,2016-04-15,3085.03,3089.95,3066.87,3078.12,189613051.0,-4.2400000000002365,4.2400000000002365,0.0,66.45311576207523,2905.25,3097.16,90.0786827158564,-9.921317284143598,41.80787365084734,36.25472854173328,0.022790934132572,31795147994.0,0
1525,2016-04-18,3058.46,3058.46,3022.97,3033.66,183304512.0,-44.46000000000004,44.46000000000004,0.0,52.36086463277494,2905.25,3097.16,66.91157313323951,-33.088426866760486,38.91249657045091,36.7862821474768,-0.0063575352022718,31611843482.0,0
1526,2016-04-19,3047.13,3054.5,3024.9,3042.82,156533200.0,9.16000000000031,0.0,9.16000000000031,54.64721562625988,2941.22,3097.16,65.15326407592686,-34.84673592407315,36.93130374027805,36.81528646603706,-0.0025470482759072,31768376682.0,1
1527,2016-04-20,3050.38,3055.69,2905.05,2972.58,283144219.0,-70.24000000000024,70.24000000000024,0.0,38.35874371471049,2905.05,3097.16,35.15173598459209,-64.8482640154079,29.35502669395646,35.32323451162094,-0.0119132302005704,31485232463.0,0
1528,2016-04-21,2954.37,2990.67,2943.46,2952.89,189406849.0,-19.69000000000005,19.69000000000005,0.0,34.98577067699573,2905.05,3097.16,24.902399666857413,-75.0976003331426,21.513954629813725,32.56137853525949,-0.0107438625643224,31295825614.0,0
1529,2016-04-22,2933.03,2960.21,2926.78,2959.24,137211668.0,6.349999999999909,0.0,6.349999999999909,37.04568847113401,2905.05,3097.16,28.20779761594904,-71.79220238405097,15.632043985488052,29.175511625305205,-0.0246278790755317,31433037282.0,1
1530,2016-04-25,2949.97,2954.09,2917.02,2946.67,125856243.0,-12.569999999999707,12.569999999999707,0.0,34.5456628488739,2905.05,3097.16,21.66467128207796,-78.33532871792205,9.842831440953889,25.308975588434944,-0.0254592958841135,31307181039.0,0
1531,2016-04-26,2944.72,2965.43,2933.97,2964.7,117711604.0,18.029999999999745,0.0,18.029999999999745,41.12178375627388,2905.05,3097.16,31.0499193170578,-68.9500806829422,6.63324518593754,21.573829507935464,-0.03324159340516,31424892643.0,1
1532,2016-04-27,2967.19,2976.02,2949.43,2953.67,130867640.0,-11.029999999999744,11.029999999999744,0.0,38.39861466507264,2905.05,3097.16,25.308417052730192,-74.69158294726981,3.163133502538585,17.891690306856088,-0.0417504769073048,31294025003.0,0
1533,2016-04-28,2955.74,2959.51,2916.37,2945.59,138663274.0,-8.079999999999927,8.079999999999927,0.0,36.3632194639327,2905.05,3097.16,21.102493363177363,-78.89750663682264,-0.2362204773626217,14.266108150012345,-0.0430555014099514,31155361729.0,0
1534,2016-04-29,2935.38,2950.58,2930.36,2938.32,109310628.0,-7.269999999999982,7.269999999999982,0.0,34.46650732764442,2905.05,3097.16,17.318203112799978,-82.68179688720002,-3.476783048768084,10.71752991025626,-0.0314273847431814,31046051101.0,0
1535,2016-05-03,2940.39,2993.53,2929.81,2992.64,168703643.0,54.31999999999971,0.0,54.31999999999971,54.79479494517378,2905.05,3097.16,45.59367029306118,-54.40632970693882,-1.6428445158371687,8.245455025037574,-0.0164912811142297,31214754744.0,1
1536,2016-05-04,2983.03,3004.42,2978.33,2991.27,165407106.0,-1.3699999999998909,1.3699999999998909,0.0,54.30458435564845,2905.05,3089.95,46.63061114115736,-53.36938885884264,-0.2965639613657913,6.5370512277569,0.0062874674525159,31049347638.0,0
1537,2016-05-05,2987.02,2999.12,2977.2,2997.84,144831383.0,6.570000000000164,0.0,6.570000000000164,56.45996919480063,2905.05,3089.95,50.18388318009743,-49.816116819902575,1.2856964612124102,5.4867802744480025,0.0152223753678599,31194179021.0,1
1538,2016-05-06,2998.4,3003.59,2913.04,2913.25,206796498.0,-84.59000000000015,84.59000000000015,0.0,33.19739536177167,2905.05,3058.46,5.345153510201308,-94.6548464897987,-4.237212853990059,3.54198164876039,-0.0155411524580635,30987382523.0,0
1539,2016-05-09,2896.16,2896.16,2821.83,2832.11,180378330.0,-81.13999999999987,81.13999999999987,0.0,22.80014302590287,2821.83,3055.69,4.395792354400151,-95.60420764559984,-14.988697783518546,-0.1641542376953982,-0.0388777840749048,30807004193.0,0
1540,2016-05-10,2822.33,2845.24,2820.16,2832.59,120829310.0,0.4800000000000182,0.0,0.4800000000000182,22.96482943601295,2820.16,3055.69,5.277459347004747,-94.72254065299526,-23.20312389316541,-4.771948168789403,-0.0445610011130973,30927833503.0,1
1541,2016-05-11,2843.54,2857.25,2818.7,2837.04,135795466.0,4.449999999999818,0.0,4.449999999999818,24.683521042186328,2818.7,3004.42,9.875080766745704,-90.1249192332543,-29.01951900593076,-9.621462336217675,-0.0394864693753872,31063628969.0,1
1542,2016-05-12,2812.11,2839.28,2781.24,2835.86,136337655.0,-1.1799999999998363,1.1799999999998363,0.0,24.51616884667517,2781.24,3004.42,24.473519132538883,-75.52648086746112,-33.339948008740976,-14.365159470722338,-0.0372522991998207,30927291314.0,0
1543,2016-05-13,2828.46,2850.09,2814.11,2827.11,114319710.0,-8.75,8.75,0.0,23.171976742873422,2781.24,3004.42,20.552916928040275,-79.44708307195972,-37.04296277722551,-18.900720132022972,-0.037848158131177,30812971604.0,0
1544,2016-05-16,2816.78,2851.23,2804.99,2850.86,114653592.0,23.75,0.0,23.75,34.43122231663706,2781.24,3004.42,31.19455148310792,-68.80544851689207,-37.62745625364823,-22.64606735634803,-0.04737622968349,30927625196.0,1
1545,2016-05-17,2850.93,2860.32,2832.46,2843.68,123369064.0,-7.180000000000291,7.180000000000291,0.0,32.75667222089561,2781.24,3004.42,27.977417331302075,-72.02258266869792,-38.22935335051898,-25.762724555182228,-0.0493402467848105,30804256132.0,0
1546,2016-05-18,2828.18,2828.26,2781.42,2807.51,140487826.0,-36.16999999999962,36.16999999999962,0.0,25.537387871780467,2781.24,3004.42,11.77076798996344,-88.22923201003657,-41.15061912897272,-28.840303469940327,-0.0634890454460544,30663768306.0,0
1547,2016-05-19,2802.31,2829.4,2801.55,2806.91,111595071.0,-0.6000000000003638,0.6000000000003638,0.0,25.430114154298423,2781.24,3004.42,11.501926695940517,-88.49807330405949,-43.01827044680476,-31.675896865313216,-0.0365021882776968,30552173235.0,0
1548,2016-05-20,2792.89,2825.95,2785.08,2825.48,108700899.0,18.570000000000164,0.0,18.570000000000164,35.15728627091099,2781.24,3004.42,19.82256474594505,-80.17743525405494,-42.509925804686645,-33.84270265318791,-0.0023410107658248,30660874134.0,1
1549,2016-05-23,2826.31,2848.07,2826.26,2843.65,120470455.0,18.170000000000076,0.0,18.170000000000076,43.48085610337945,2781.24,3004.42,27.963975266601054,-72.03602473339895,-40.17774779955562,-35.10971168246145,0.0039045537829336,30781344589.0,1
1550,2016-05-24,2839.68,2839.7,2807.19,2821.67,111452445.0,-21.980000000000015,21.980000000000015,0.0,36.87407074826341,2781.24,3003.59,18.18304474926927,-81.81695525073073,-39.64606705137976,-36.01698275624511,-0.0054176183628006,30669892144.0,0
1551,2016-05-25,2835.03,2843.17,2807.75,2815.09,103527265.0,-6.579999999999927,6.579999999999927,0.0,35.03523371251423,2781.24,3003.59,15.223746345851277,-84.77625365414873,-39.30260131362047,-36.674106467720186,-0.0073240568998469,30566364879.0,0
1552,2016-05-26,2813.54,2827.09,2780.76,2822.44,114766797.0,7.349999999999909,0.0,7.349999999999909,38.95857571992718,2780.76,2896.16,36.11785095320621,-63.88214904679379,-37.999286546844814,-36.93914248354511,-0.0016518635638514,30681131676.0,1
1553,2016-05-27,2817.97,2832.8,2809.8,2821.05,109845823.0,-1.389999999999873,1.389999999999873,0.0,38.45185236434013,2780.76,2860.32,50.64102564102563,-49.35897435897437,-36.65601387718425,-36.88251676227294,-0.0104564938299319,30571285853.0,0
1554,2016-05-30,2814.65,2830.97,2794.66,2822.45,106319589.0,1.3999999999996362,0.0,1.3999999999996362,39.36834382803351,2780.76,2860.32,52.40070387129164,-47.59929612870836,-35.07417900634209,-36.52084921108678,-0.0074656782760367,30677605442.0,1
1555,2016-05-31,2822.59,2917.14,2822.59,2916.62,215260341.0,94.17000000000009,0.0,94.17000000000009,71.87382341275638,2780.76,2917.14,99.61871242117614,-0.3812875788238621,-25.923007195781796,-34.40128080802578,0.0388636193637776,30892865783.0,1
1556,2016-06-01,2917.15,2929.08,2909.51,2913.51,188386421.0,-3.1099999999996726,3.1099999999996726,0.0,70.43488994964329,2780.76,2929.08,89.5024271844662,-10.497572815533806,-18.70595797445094,-31.262216241310814,0.0379777050208236,30704479362.0,0
1557,2016-06-02,2911.22,2925.67,2906.52,2925.23,159716916.0,11.7199999999998,0.0,11.7199999999998,72.80251957952804,2780.76,2929.08,97.40426105717374,-2.5957389428262654,-11.903472596205576,-27.390467512289767,0.0353037360023784,30864196278.0,1
1558,2016-06-03,2929.79,2945.52,2915.19,2938.68,172021023.0,13.449999999999818,0.0,13.449999999999818,75.41007772704728,2780.76,2945.52,95.84850691915504,-4.15149308084496,-5.365303452610078,-22.985434700353828,0.0334183180067868,31036217301.0,1
1559,2016-06-06,2940.99,2945.94,2922.28,2934.1,141993742.0,-4.579999999999927,4.579999999999927,0.0,72.67249956732984,2780.76,2945.94,92.83206199297726,-7.1679380070227365,-0.5470193264018235,-18.497751625563428,0.03984519805647,30894223559.0,0
1560,2016-06-07,2936.28,2938.44,2923.5,2936.04,132987867.0,1.9400000000000543,0.0,1.9400000000000543,73.14891210679669,2780.76,2945.94,94.00653832183067,-5.993461678169331,3.388981277624225,-14.120405044925896,0.0429648785651612,31027211426.0,1
1561,2016-06-08,2932.38,2937.99,2908.37,2927.16,143046071.0,-8.88000000000011,8.88000000000011,0.0,66.9815739041509,2780.76,2945.94,88.63058481656361,-11.369415183436384,5.7257454969872015,-10.151174936543276,0.0371026487719845,30884165355.0,0
1562,2016-06-13,2897.27,2911.16,2832.51,2833.07,169255434.0,-94.08999999999968,94.08999999999968,0.0,32.98308646882049,2780.76,2945.94,31.6684828671752,-68.3315171328248,-0.0144619721386334,-8.123832343662347,0.0042608248701725,30714909921.0,0
1563,2016-06-14,2824.23,2843.46,2822.06,2842.19,119755274.0,9.11999999999989,0.0,9.11999999999989,36.58313451354895,2780.76,2945.94,37.18973241312501,-62.81026758687499,-3.784089340004812,-7.255883742930839,0.006993923718755,30834665195.0,1
1564,2016-06-15,2814.69,2894.26,2811.78,2887.21,166671069.0,45.01999999999998,0.0,45.01999999999998,51.44088855182135,2780.76,2945.94,64.4448480445574,-35.5551519554426,-3.1030385388739887,-6.42531470211947,-0.010083589908867,31001336264.0,1
1565,2016-06-16,2878.4,2887.74,2865.39,2872.82,173882767.0,-14.389999999999873,14.389999999999873,0.0,47.349532309921415,2780.76,2945.94,55.73313960527911,-44.26686039472089,-3.682009694240151,-5.876653700543607,-0.01396597231518,30827453497.0,0
1566,2016-06-17,2873.01,2900.3,2872.18,2885.1,171472517.0,12.279999999999744,0.0,12.279999999999744,51.1733831852683,2794.66,2945.94,59.78318350079319,-40.216816499206814,-3.114058209763698,-5.324134602387626,-0.013718579393757,30998926014.0,1
1567,2016-06-20,2887.64,2891.66,2864.02,2888.81,136571051.0,3.710000000000037,0.0,3.710000000000037,52.37903080570727,2794.66,2945.94,62.23558963511368,-37.76441036488632,-2.3376397166857714,-4.726835625247255,-0.0169702043094177,31135497065.0,1
1568,2016-06-21,2898.38,2919.3,2869.18,2878.56,164359089.0,-10.25,10.25,0.0,48.55684265125223,2811.78,2945.94,49.77638640429324,-50.22361359570675,-2.520358678329103,-4.285540235863625,-0.0189291435193074,30971137976.0,0
1569,2016-06-22,2872.73,2905.98,2869.51,2905.55,130590424.0,26.99000000000024,0.0,26.99000000000024,57.8924310983631,2811.78,2945.94,69.8941562313656,-30.105843768634404,-0.4817440906904267,-3.524781006828985,-0.0103847359027805,31101728400.0,1
1570,2016-06-23,2902.4,2904.11,2878.66,2891.96,136137375.0,-13.590000000000146,13.590000000000146,0.0,52.37079561563348,2811.78,2945.94,59.76446034585564,-40.23553965414436,0.0368484676096159,-2.8124551119412646,-0.0120253078068843,30965591025.0,0
1571,2016-06-24,2883.76,2899.57,2807.6,2854.29,190842609.0,-37.67000000000007,37.67000000000007,0.0,40.12936223935348,2807.6,2945.94,33.750180714182456,-66.24981928581755,-2.5622809920423606,-2.762420287961484,0.0074901079041462,30774748416.0,0
1572,2016-06-27,2840.56,2895.73,2840.28,2895.7,156697472.0,41.409999999999854,0.0,41.409999999999854,53.82075056702264,2807.6,2945.94,63.68367789504107,-36.31632210495893,-1.2660743750507208,-2.463151105379332,0.0188270312681417,30931445888.0,1
1573,2016-06-28,2885.01,2913.58,2878.82,2912.56,173871047.0,16.860000000000127,0.0,16.860000000000127,58.30060222643098,2807.6,2938.44,80.22011617242427,-19.779883827575727,1.10885758270706,-1.7487493677620534,0.0087801025903899,31105316935.0,1
1574,2016-06-29,2918.53,2934.0,2915.06,2931.59,193215586.0,19.0300000000002,0.0,19.0300000000002,62.978013962910175,2807.6,2937.99,95.09164813252578,-4.9083518674742255,4.474985383426429,-0.5040024175243566,0.0204572510634151,31298532521.0,1
1575,2016-06-30,2931.48,2938.14,2922.31,2929.61,154464930.0,-1.9800000000000184,1.9800000000000184,0.0,62.14119839472831,2807.6,2938.14,93.46560441244084,-6.534395587559176,6.9033192969986885,0.977461925380253,0.0154275415063602,31144067591.0,0
1576,2016-07-01,2931.8,2944.99,2925.81,2932.48,141246227.0,2.869999999999891,0.0,2.869999999999891,62.96424903808549,2807.6,2944.99,90.89453380886545,-9.105466191134562,8.956135676042777,2.5731966755127584,0.0151169512705924,31285313818.0,1
1577,2016-07-04,2924.29,2992.5,2922.52,2988.6,222017132.0,56.11999999999989,0.0,56.11999999999989,75.1522115444086,2807.6,2992.5,97.89075175770682,-2.10924824229318,14.939212489527108,5.046399838315629,0.0382274470568617,31507330950.0,1
1578,2016-07-05,2991.75,3010.27,2990.64,3006.39,235204450.0,17.789999999999964,0.0,17.789999999999964,77.82178972302935,2807.6,3010.27,98.08555780332556,-1.9144421966744496,20.87570614693459,8.212261100039424,0.0347059937017086,31742535400.0,1
1579,2016-07-06,2998.52,3017.65,2984.83,3017.29,212370920.0,10.900000000000093,0.0,10.900000000000093,79.38740828056882,2807.6,3017.65,99.82861223518204,-0.1713877648179609,26.15842105063666,11.801493090158871,0.0433373905586522,31954906320.0,1
1580,2016-07-07,3009.35,3024.11,2994.64,3016.85,222681667.0,-0.4400000000000545,0.4400000000000545,0.0,79.12723688328444,2807.6,3024.11,96.64680615214068,-3.353193847859319,29.96409886919946,15.434014245966994,0.0569528674381369,31732224653.0,0
1581,2016-07-08,3000.33,3001.55,2983.88,2988.09,168986859.0,-28.759999999999764,28.759999999999764,0.0,63.445537668828976,2807.6,3024.11,83.3633550413376,-16.63664495866239,30.31003905332409,18.40921920743841,0.0319059294816452,31563237794.0,0
1582,2016-07-11,2993.75,3022.94,2990.91,2994.92,224338224.0,6.829999999999927,0.0,6.829999999999927,65.3284089005742,2807.6,3024.11,86.5179437439379,-13.482056256062084,30.78050456449546,20.883476278849827,0.0282775290466119,31787576018.0,1
1583,2016-07-12,2992.52,3049.68,2984.42,3049.38,259486295.0,54.46000000000004,0.0,54.46000000000004,76.47626471990606,2807.6,3049.68,99.87607402511578,-0.123925974884223,35.142715383054565,23.73532409969078,0.0401795612619773,32047062313.0,1
1584,2016-07-13,3049.51,3069.05,3048.2,3060.69,253659384.0,11.309999999999944,0.0,11.309999999999944,78.15902577361736,2807.6,3069.05,96.8024478867852,-3.197552113214809,39.06213735904112,26.80068675156085,0.0447431569389782,32300721697.0,1
1585,2016-07-14,3054.97,3057.05,3036.52,3054.02,180194804.0,-6.670000000000073,6.670000000000073,0.0,74.53104868093814,2840.28,3069.05,93.4300826157275,-6.569917384272501,41.155677227874094,29.6716848468235,0.0414461479703185,32120526893.0,0
1586,2016-07-15,3056.68,3062.68,3044.54,3054.3,172866398.0,0.2800000000002001,0.0,0.2800000000002001,74.58818354689237,2878.82,3069.05,92.24622825001316,-7.753771749986857,42.34924063248173,32.20719600395515,0.0219835374422807,32293393291.0,1
1587,2016-07-18,3047.64,3058.32,3031.64,3043.56,177496562.0,-10.740000000000236,10.740000000000236,0.0,67.85153369162148,2915.06,3069.05,83.4469770764334,-16.553022923566594,41.94500409042303,34.15475762124873,0.0123636653927134,32115896729.0,0
1588,2016-07-19,3040.23,3043.6,3014.29,3036.6,155361466.0,-6.960000000000036,6.960000000000036,0.0,63.5590911760754,2922.31,3069.05,77.8860569715141,-22.11394302848591,40.59507512908976,35.44282112281694,0.0063997825863606,31960535263.0,0
1589,2016-07-20,3034.71,3043.0,3022.63,3027.9,138242815.0,-8.699999999999818,8.699999999999818,0.0,58.24463683120113,2922.52,3069.05,71.91701358083667,-28.082986419163337,38.38079944566243,36.03041678738604,0.0036627608266901,31822292448.0,0
1590,2016-07-21,3027.6,3053.33,3027.37,3039.01,163767370.0,11.110000000000127,0.0,11.110000000000127,62.82476317976326,2922.52,3069.05,79.49907868695836,-20.500921313041644,37.094847848154586,36.24330299953975,0.0170409860479436,31986059818.0,1
1591,2016-07-22,3038.12,3039.27,3007.46,3012.82,162010181.0,-26.19000000000005,26.19000000000005,0.0,48.38793908423996,2983.88,3069.05,33.979100622284875,-66.02089937771512,33.57537183474369,35.70971676658054,0.0059767873599294,31824049637.0,0
1592,2016-07-25,3008.09,3027.12,3003.29,3015.83,144206582.0,3.0099999999997635,0.0,3.0099999999997635,49.91421889577195,2983.88,3069.05,37.51320887636467,-62.486791123635335,30.675436247772268,34.702860662818885,-0.0110022365202107,31968256219.0,1
1593,2016-07-26,3014.04,3050.61,3013.8,3050.17,156694506.0,34.340000000000146,0.0,34.340000000000146,63.94844949271858,2983.88,3069.05,77.83257015380993,-22.16742984619008,30.793202540056427,33.920929038266394,-0.0034371334568349,32124950725.0,1
1594,2016-07-27,3050.37,3057.42,2939.23,2992.0,280160915.0,-58.17000000000007,58.17000000000007,0.0,41.31911278662461,2939.23,3069.05,40.6485903558773,-59.3514096441227,25.894208010763123,32.31558483276574,-0.020307660067714,31844789810.0,0
1595,2016-07-28,2980.5,3003.36,2968.18,2994.32,190564950.0,2.320000000000164,0.0,2.320000000000164,42.25939871205116,2939.23,3069.05,42.43568017254666,-57.56431982745334,21.94594496917125,30.24165686004684,-0.0196378875683462,32035354760.0,1
1596,2016-07-29,2992.54,3000.05,2972.92,2979.34,150101534.0,-14.980000000000018,14.980000000000018,0.0,37.752472951318126,2939.23,3069.05,30.896626097673764,-69.10337390232624,17.40749449534087,27.674824387105648,-0.0211002904493421,31885253226.0,0
1597,2016-08-01,2971.95,2972.88,2931.96,2953.39,147407763.0,-25.950000000000276,25.950000000000276,0.0,31.118808417109207,2931.96,3069.05,15.632066525639951,-84.36793347436004,11.583266978860138,24.456512905456545,-0.0274023579002832,31737845463.0,0
1598,2016-08-02,2950.08,2971.28,2946.64,2971.28,115468900.0,17.890000000000327,0.0,17.890000000000327,39.56596555505077,2931.96,3062.68,30.079559363525263,-69.92044063647474,8.315245226872776,21.228259369739792,-0.0186994286469169,31853314363.0,1
1599,2016-08-03,2963.21,2981.16,2956.79,2978.46,141141332.0,7.179999999999836,0.0,7.179999999999836,42.81358267027657,2931.96,3062.68,35.57221542227668,-64.42778457772333,6.232832227716244,18.229173941335084,-0.0199242516477405,31994455695.0,1
1600,2016-08-04,2976.41,2982.86,2958.93,2982.43,133933301.0,3.9699999999998,0.0,3.9699999999998,44.709197494985325,2931.96,3058.32,39.94143716365919,-60.05856283634081,4.846977801279991,15.552734713324066,-0.0100868953339396,32128388996.0,1
1601,2016-08-05,2978.78,2991.68,2971.56,2976.7,141857101.0,-5.730000000000018,5.730000000000018,0.0,42.37020006928197,2931.96,3057.42,35.66076837238942,-64.33923162761059,3.2488641873915185,13.091960608137557,-0.0129748692731354,31986531895.0,0
1602,2016-08-08,2972.62,3004.72,2959.05,3004.28,155729833.0,27.580000000000386,0.0,27.580000000000386,55.34476479759855,2931.96,3057.42,57.64387055635274,-42.35612944364726,4.159870738476911,11.305542634205429,-0.0150450630620587,32142261728.0,1
1603,2016-08-09,3001.31,3025.91,2998.68,3025.68,169995446.0,21.39999999999964,0.0,21.39999999999964,62.83574335500061,2931.96,3057.42,74.70109995217581,-25.29890004782419,6.533338882621592,10.351101883888662,0.0112566844919785,32312257174.0,1
1604,2016-08-10,3023.47,3033.2,3017.09,3018.75,164675165.0,-6.929999999999836,6.929999999999836,0.0,59.1294693605902,2931.96,3057.42,69.17742706838828,-30.82257293161172,7.765619179229361,9.834005342956802,0.0081587806246492,32147582009.0,0
1605,2016-08-11,3013.68,3038.05,3001.17,3002.64,161879481.0,-16.110000000000127,16.110000000000127,0.0,51.05234654932042,2931.96,3057.42,56.33668101386882,-43.66331898613118,7.357455660283449,9.338695406422133,0.007820524008673,31985702528.0,0
1606,2016-08-12,3000.27,3051.05,2999.04,3050.67,168173657.0,48.0300000000002,0.0,48.0300000000002,66.7003106165642,2931.96,3057.42,94.61979913916784,-5.3802008608321366,10.78527677039392,9.62801167921649,0.0329384199174509,32153876185.0,1
1607,2016-08-15,3056.48,3137.48,3053.87,3125.2,297616506.0,74.52999999999975,0.0,74.52999999999975,78.8222520270825,2931.96,3137.48,94.02491241728288,-5.975087582717109,19.29339556868172,11.561088457109538,0.0518025901295062,32451492691.0,1
1608,2016-08-16,3130.53,3140.44,3102.07,3110.04,278328934.0,-15.159999999999854,15.159999999999854,0.0,72.61796265666047,2931.96,3140.44,85.41826554105906,-14.581734458940948,24.53008812496228,14.154888390680089,0.0441771922402851,32173163757.0,0
1609,2016-08-17,3106.99,3114.25,3090.28,3109.55,213839637.0,-0.4899999999997817,0.4899999999997817,0.0,72.40541367382141,2931.96,3140.44,85.18323100537228,-14.81676899462772,28.314276445409178,16.986766001625906,0.0426229618130182,31959324120.0,0
1610,2016-08-18,3107.75,3125.58,3093.32,3104.11,229359081.0,-5.440000000000055,5.440000000000055,0.0,69.78873135008354,2931.96,3140.44,82.57386799693019,-17.426132003069803,30.522466423589776,19.69390608601868,0.0428024322236033,31729965039.0,0
1611,2016-08-19,3100.39,3113.34,3082.77,3108.1,194347453.0,3.9899999999997817,0.0,3.9899999999997817,70.68530755074494,2946.64,3140.44,83.31269349845195,-16.687306501548047,32.22298601990133,22.19972207279521,0.0345573648261812,31924312492.0,1
1612,2016-08-22,3107.38,3112.74,3083.59,3084.81,185387927.0,-23.289999999999964,23.289999999999964,0.0,58.91046306950126,2956.79,3140.44,69.70868499863867,-30.29131500136133,31.330196689149943,24.02581699606616,0.0195427143650352,31738924565.0,0
1613,2016-08-23,3081.57,3101.11,3073.53,3089.71,161368965.0,4.900000000000091,0.0,4.900000000000091,60.507500685207326,2958.93,3140.44,72.0511266596882,-27.948873340311803,30.66456178113458,25.353565953079848,0.0235064182194617,31900293530.0,1
1614,2016-08-24,3092.02,3097.15,3079.55,3085.88,145707440.0,-3.8299999999999272,3.8299999999999272,0.0,58.45831737555625,2959.05,3140.44,69.92116434202548,-30.078835657974523,29.48807218903039,26.180467200269955,0.0277222710681268,31754586090.0,0
1615,2016-08-25,3073.44,3073.44,3041.51,3068.33,174032980.0,-17.550000000000182,17.550000000000182,0.0,49.58045588790692,2959.05,3140.44,60.24587904515123,-39.754120954848766,26.83027467739248,26.310428695694466,0.0057888922761228,31580553110.0,0
1616,2016-08-26,3069.85,3087.65,3063.89,3070.31,149663901.0,1.9800000000000184,0.0,1.9800000000000184,50.557906630180646,2998.68,3140.44,50.5290632054176,-49.47093679458239,24.60014529160935,25.96837201487744,-0.0175636759247407,31730217011.0,1
1617,2016-08-29,3068.46,3074.94,3058.79,3070.03,144500007.0,-0.2799999999997453,0.2799999999997453,0.0,50.398482456844654,2999.04,3140.44,50.20509193776535,-49.79490806223466,22.55021320540709,25.284740252983376,-0.0128647863049992,31585717004.0,0
1618,2016-08-30,3071.44,3082.99,3065.97,3074.68,140434811.0,4.649999999999636,0.0,4.649999999999636,53.22481606304536,2999.04,3140.44,53.49363507779336,-46.50636492220664,21.05809874236684,24.43941195086007,-0.0112138412310464,31726151815.0,1
1619,2016-08-31,3072.92,3087.7,3063.4,3085.49,141368609.0,10.809999999999944,0.0,10.809999999999944,59.42627642999966,2999.04,3140.44,61.13861386138597,-38.86138613861403,20.511421043490373,23.653813769386133,-0.0059984987645412,31867520424.0,1
1620,2016-09-01,3083.96,3088.7,3062.88,3063.31,155191093.0,-22.17999999999984,22.17999999999984,0.0,45.229642642165736,3041.51,3140.44,22.03578287678132,-77.96421712321869,18.080019187750167,22.539054853058943,-0.0144107332453911,31712329331.0,0
1621,2016-09-02,3057.49,3072.53,3050.49,3067.35,150446920.0,4.039999999999964,0.0,4.039999999999964,47.848095524098525,3041.51,3140.44,26.11947841908393,-73.88052158091607,16.291313811454074,21.289506644737973,-0.0056599920254407,31862776251.0,1
1622,2016-09-05,3070.71,3085.49,3065.33,3072.1,144963317.0,4.75,0.0,4.75,51.02451661632091,3041.51,3125.58,36.386344712739145,-63.61365528726086,15.083167846419656,20.048238885074312,-0.0056995640367543,32007739568.0,1
1623,2016-09-06,3071.06,3095.51,3053.19,3090.71,172908524.0,18.610000000000127,0.0,18.610000000000127,61.59808256572472,3041.51,3125.58,58.52265968835493,-41.47734031164507,15.449285191803485,19.128448146420148,0.0015651937210778,32180648092.0,1
1624,2016-09-07,3091.33,3105.68,3087.88,3091.93,186956763.0,1.2199999999998,0.0,1.2199999999998,62.21513488327528,3041.51,3113.34,70.19351245997449,-29.80648754002552,15.657390973038671,18.434236711743853,0.0076914803818364,32367604855.0,1
1625,2016-09-08,3089.95,3096.78,3083.9,3095.95,145883771.0,4.019999999999982,0.0,4.019999999999982,64.39057988803464,3041.51,3112.74,76.42847114979634,-23.57152885020366,15.962688767760936,17.93992712294727,0.0083509482755812,32513488626.0,1
1626,2016-09-09,3095.43,3101.79,3078.22,3078.85,160692924.0,-17.09999999999991,17.09999999999991,0.0,50.20377563026511,3041.51,3105.68,58.18918497740364,-41.810815022596366,14.655868649463171,17.28311542825045,0.0028729360950869,32352795702.0,0
1627,2016-09-12,3037.51,3040.95,2999.93,3021.98,206012086.0,-56.86999999999989,56.86999999999989,0.0,27.203815428362404,2999.93,3105.68,20.851063829787407,-79.1489361702126,8.928350110631527,15.612162364726666,-0.017139995056396,32146783616.0,0
1628,2016-09-13,3025.03,3029.72,3008.74,3023.51,135387580.0,1.5300000000002,0.0,1.5300000000002,28.22457297373228,2999.93,3105.68,22.297872340425894,-77.7021276595741,4.461281738491834,13.3819862394797,-0.020087571179942,32282171196.0,1
1629,2016-09-14,3008.9,3017.94,2995.42,3002.85,133413401.0,-20.66000000000031,20.66000000000031,0.0,23.163860003255166,2995.42,3105.68,6.738617812443182,-93.26138218755682,-0.7374901398338807,10.558090963616984,-0.0197368206286664,32148757795.0,0
1630,2016-09-19,3005.32,3026.65,3005.32,3026.05,119225027.0,23.200000000000276,0.0,23.200000000000276,37.649287621409904,2995.42,3105.68,27.77979321603499,-72.22020678396501,-2.9514853135674457,7.856175708180098,-0.0134643910867686,32267982822.0,1
1631,2016-09-20,3027.17,3027.82,3015.88,3023.0,118924117.0,-3.050000000000182,3.050000000000182,0.0,36.60255222304573,2995.42,3105.68,25.01360420823507,-74.98639579176493,-4.895766599956005,5.305787246552877,-0.0159825526512809,32149058705.0,0
1632,2016-09-21,3021.58,3032.45,3017.54,3025.87,115721213.0,2.869999999999891,0.0,2.869999999999891,38.46021171146152,2995.42,3105.68,27.616542717213758,-72.38345728278624,-6.134325823195468,3.017764632603208,-0.0209789983531292,32264779918.0,1
1633,2016-09-22,3038.42,3054.44,3035.07,3042.31,139309554.0,16.440000000000055,0.0,16.440000000000055,48.44488615455214,2995.42,3105.68,42.5267549428623,-57.4732450571377,-5.723347142562488,1.2695422775700682,-0.0160482287762012,32404089472.0,1
1634,2016-09-23,3044.79,3046.8,3032.8,3033.9,125590976.0,-8.409999999999854,8.409999999999854,0.0,44.21090068606166,2995.42,3105.68,34.899328859060496,-65.1006711409395,-6.007015160384981,-0.185769210020942,-0.0200423133448536,32278498496.0,0
1635,2016-09-26,3028.24,3028.24,2980.12,2980.43,144330286.0,-53.470000000000255,53.470000000000255,0.0,26.93888230737862,2980.12,3105.68,0.2468939152595934,-99.7531060847404,-10.42621927508526,-2.2338592230338064,-0.0319664809912791,32134168210.0,0
1636,2016-09-27,2974.59,2998.23,2969.13,2998.17,121701450.0,17.740000000000236,0.0,17.740000000000236,36.444078528846745,2969.13,3105.68,21.266935188575623,-78.73306481142437,-12.354584672356395,-4.258004312898325,-0.0078789402974208,32255869660.0,1
1637,2016-09-28,3000.7,3000.7,2984.32,2987.86,104625697.0,-10.309999999999944,10.309999999999944,0.0,33.5197355004168,2969.13,3105.68,13.716587330648156,-86.28341266935185,-14.547069417541934,-6.315817333827048,-0.0117909317316629,32151243963.0,0
1638,2016-09-29,2992.17,3009.2,2991.91,2998.48,113213919.0,10.61999999999989,0.0,10.61999999999989,39.30797785144479,2969.13,3101.79,22.1242273481079,-77.87577265189209,-15.25187006499482,-8.103027880060603,-0.0014552841467272,32264457882.0,1
1639,2016-09-30,2994.25,3009.2,2993.06,3004.7,101333562.0,6.2199999999998,0.0,6.2199999999998,42.6806123984571,2969.13,3101.79,26.812905171113936,-73.18709482888607,-15.134071483198111,-9.509236600688103,-0.0070554022570679,32365791444.0,1
1640,2016-10-10,3020.46,3048.24,3014.62,3048.14,160051104.0,43.440000000000055,0.0,43.440000000000055,60.40934535343289,2969.13,3054.44,92.61516821005722,-7.384831789942781,-11.404011950643962,-9.888191670679277,0.0083162421435658,32525842548.0,1
1641,2016-10-11,3051.62,3066.1,3048.02,3065.25,167273496.0,17.110000000000127,0.0,17.110000000000127,65.28862858719994,2969.13,3066.1,99.12344023924936,-0.8765597607506557,-6.986740100914176,-9.307901356726257,0.0130144388225534,32693116044.0,1
1642,2016-10-12,3057.32,3060.51,3048.89,3058.5,142493577.0,-6.75,6.75,0.0,61.82048232280264,2969.13,3066.1,92.16252449211105,-7.837475507888961,-3.984755146271709,-8.243272114635348,0.0053216141681813,32550622467.0,0
1643,2016-10-13,3057.97,3065.0,3052.64,3061.35,154756725.0,2.849999999999909,0.0,2.849999999999909,62.783608343265584,2969.13,3066.1,95.10157780756934,-4.898422192430659,-1.3600118895437845,-6.866620069617035,0.0090477603085137,32705379192.0,1
1644,2016-10-14,3056.99,3064.79,3043.18,3063.81,155373705.0,2.4600000000000364,0.0,2.4600000000000364,63.6957213408701,2969.13,3066.1,97.6384448798598,-2.361555120140217,0.908148917175822,-5.311666272258464,0.0279758289911187,32860752897.0,1
1645,2016-10-17,3064.69,3068.81,3033.75,3041.17,163733265.0,-22.639999999999876,22.639999999999876,0.0,50.54182241080214,2969.13,3068.81,72.271268057785,-27.728731942215006,0.8688088208205045,-4.07557125364267,0.0143420820033552,32697019632.0,0
1646,2016-10-18,3037.4,3084.19,3037.4,3083.88,182042460.0,42.71000000000004,0.0,42.71000000000004,65.87952627272746,2969.13,3084.19,99.73057535199032,-0.2694246480096867,4.235151379848958,-2.413426726944344,0.0321367132328824,32879062092.0,1
1647,2016-10-19,3085.75,3096.22,3076.77,3084.72,182470143.0,0.8399999999996908,0.0,0.8399999999996908,66.11797184314146,2969.13,3096.22,90.95129435832872,-9.048705641671278,6.891343967351077,-0.5524725880852591,0.028761239027774,33061532235.0,1
1648,2016-10-20,3084.91,3089.68,3076.29,3084.46,160691364.0,-0.2599999999997635,0.2599999999997635,0.0,65.95336301587322,2969.13,3096.22,90.74671492643024,-9.253285073569748,8.873131960780483,1.33264832168789,0.0265450793756449,32900840871.0,0
1649,2016-10-21,3081.39,3101.85,3069.27,3090.94,187388072.0,6.480000000000018,0.0,6.480000000000018,68.22807634579333,2969.13,3101.85,91.77968655816768,-8.220313441832332,10.841619625595284,3.2344425824693697,0.0140413498067675,33088228943.0,1
1650,2016-10-24,3092.05,3137.03,3090.79,3128.25,240522349.0,37.309999999999945,0.0,37.309999999999945,77.99522090255024,2984.32,3137.03,94.25054023966985,-5.749459760330167,15.236627116540603,5.634879489283617,0.0205529728407145,33328751292.0,1
1651,2016-10-25,3127.97,3132.5,3121.05,3131.94,203380898.0,3.690000000000055,0.0,3.690000000000055,78.74100954620296,2991.91,3137.03,96.49255788313113,-3.5074421168688903,18.800731251992147,8.268049841825325,0.0240117704757234,33532132190.0,1
1652,2016-10-26,3129.84,3129.84,3110.39,3116.31,191663263.0,-15.63000000000011,15.63000000000011,0.0,67.55142888391468,2993.06,3137.03,85.6081128012779,-14.39188719872211,20.13202957746671,10.640845788953603,0.0179528639325787,33340468927.0,0
1653,2016-10-27,3112.6,3114.76,3100.39,3112.35,158008789.0,-3.960000000000037,3.960000000000037,0.0,64.85707697013561,3014.62,3137.03,79.83824850910854,-20.16175149089145,20.62974730167025,12.638626091496937,0.0158430189861642,33182460138.0,0
1654,2016-10-28,3111.7,3128.64,3101.24,3104.27,181774123.0,-8.079999999999927,8.079999999999927,0.0,59.2895536876463,3033.75,3137.03,68.28040278853587,-31.71959721146413,20.140041845686028,14.138909242334757,0.0207485934689608,33000686015.0,0
1655,2016-10-31,3097.19,3102.3,3081.07,3100.49,151506764.0,-3.7800000000002,3.7800000000002,0.0,56.66388824509531,3033.75,3137.03,64.620449264136,-35.37955073586401,19.22531487195738,15.15619036825928,0.0053860720910021,32849179251.0,0
1656,2016-11-01,3101.66,3122.61,3097.04,3122.44,160232032.0,21.950000000000276,0.0,21.950000000000276,66.58029707994557,3033.75,3137.03,85.87335398915558,-14.12664601084442,20.040553683173584,16.13306303124214,0.0122280142119868,33009411283.0,1
1657,2016-11-02,3115.73,3118.98,3099.82,3102.73,182722067.0,-19.71000000000004,19.71000000000004,0.0,53.82029936445051,3033.75,3137.03,66.78931061192863,-33.21068938807137,18.878583479047396,16.682167120803193,0.0059232410211187,32826689216.0,0
1658,2016-11-03,3096.76,3140.93,3094.1,3128.94,222986260.0,26.21000000000004,0.0,26.21000000000004,64.31404429150504,3033.75,3140.93,88.81321142004124,-11.18678857995876,19.84389362135289,17.314512420913132,0.0122939947071116,33049675476.0,1
1659,2016-11-04,3126.35,3141.33,3119.54,3125.32,197683197.0,-3.619999999999891,3.619999999999891,0.0,62.06641088290911,3037.4,3141.33,84.59540075050536,-15.40459924949465,20.08527457476748,17.868664851684002,-0.0009366259090545,32851992279.0,0
1660,2016-11-07,3124.89,3139.2,3117.1,3133.33,179418490.0,8.009999999999764,0.0,8.009999999999764,65.17381287546722,3069.27,3141.33,88.89814043852344,-11.101859561476555,20.684473047388565,18.431826490824918,0.0004438143770313,33031410769.0,1
1661,2016-11-08,3140.94,3156.88,3134.95,3147.89,190846979.0,14.559999999999944,0.0,14.559999999999944,70.28002356545515,3069.27,3156.88,89.73861431343428,-10.261385686565715,22.079691531095705,19.161399498879074,0.010133780015467,33222257748.0,1
1662,2016-11-09,3146.08,3146.95,3096.95,3128.37,241114958.0,-19.519999999999985,19.519999999999985,0.0,57.28687806652631,3069.27,3156.88,67.458052733706,-32.541947266294,21.364040012277652,19.601927601558792,0.005147236011374,32981142790.0,0
1663,2016-11-10,3148.54,3172.31,3148.54,3171.28,244192602.0,42.91000000000031,0.0,42.91000000000031,70.92231029250983,3081.07,3172.31,98.87110916264824,-1.128890837351762,23.982899477452065,20.478121976737448,0.0215863955132769,33225335392.0,1
1664,2016-11-11,3169.4,3202.74,3166.07,3196.04,310854579.0,24.759999999999764,0.0,24.759999999999764,76.01925862828715,3081.07,3202.74,94.49330155338224,-5.506698446617769,27.73655974814528,21.929809531019018,0.0308177094588275,33536189971.0,1
1665,2016-11-14,3187.71,3221.46,3186.8,3210.37,329608313.0,14.329999999999927,0.0,14.329999999999927,78.53219468900323,3081.07,3221.46,92.10057696417113,-7.899423035828873,31.50450942178577,23.84474950917237,0.0281606692202252,33865798284.0,1
1666,2016-11-15,3209.95,3214.29,3195.04,3206.99,240886350.0,-3.380000000000109,3.380000000000109,0.0,76.3546223884271,3081.07,3221.46,89.6929980767859,-10.307001923214097,33.827951366412435,25.841389880620383,0.0336026660392621,33624911934.0,0
1667,2016-11-16,3208.5,3210.89,3195.41,3205.06,221766993.0,-1.9299999999998363,1.9299999999998363,0.0,74.98473079340877,3081.07,3221.46,88.31825628606018,-11.681743713939817,35.10884803110412,27.69488151071713,0.0243277276010405,33403144941.0,0
1668,2016-11-17,3198.5,3211.05,3187.21,3208.45,214206240.0,3.3899999999998727,0.0,3.3899999999998727,75.86240855692968,3081.07,3221.46,90.73295818790496,-9.267041812095044,35.982726067189105,29.352450422011533,0.0265988762750692,33617351181.0,1
1669,2016-11-18,3207.19,3212.39,3187.5,3192.86,209826639.0,-15.58999999999969,15.58999999999969,0.0,63.955427923115366,3094.1,3221.46,77.54396984924632,-22.45603015075368,35.01368206620464,30.484696750850155,0.0189989563818686,33407524542.0,0
1670,2016-11-21,3188.5,3229.76,3188.28,3218.15,230652844.0,25.289999999999964,0.0,25.289999999999964,72.14015696317298,3094.1,3229.76,91.4418398938522,-8.558160106147797,35.872879135904896,31.56233322786111,0.0223197125693719,33638177386.0,1
1671,2016-11-22,3220.98,3249.68,3220.98,3248.35,261631547.0,30.199999999999815,0.0,30.199999999999815,78.77951114848801,3094.1,3249.68,99.14513433603295,-0.8548656639670446,38.54634830292389,32.95913624287367,0.0383522409433667,33899808933.0,1
1672,2016-11-23,3247.94,3262.88,3231.59,3241.14,249959592.0,-7.210000000000036,7.210000000000036,0.0,73.92637147190021,3096.95,3262.88,86.89808955583668,-13.10191044416332,39.62651533346116,34.29261206099117,0.0220289599152392,33649849341.0,0
1673,2016-11-24,3237.43,3257.86,3232.87,3241.74,232324527.0,0.599999999999909,0.0,0.599999999999909,74.07969665128823,3096.95,3262.88,87.25968782016496,-12.740312179835044,40.069079071534816,35.4479054630999,0.0142989449443686,33882173868.0,1
1674,2016-11-25,3241.24,3262.44,3209.6,3261.94,233921601.0,20.200000000000276,0.0,20.200000000000276,78.89971195786777,3096.95,3262.88,99.43349605255224,-0.5665039474477508,41.57058537262856,36.67244144500563,0.0160635689967201,34116095469.0,1
1675,2016-11-28,3270.05,3288.34,3267.67,3277.0,281551253.0,15.059999999999944,0.0,15.059999999999944,81.8095758324566,3096.95,3288.34,94.07492554469924,-5.925074455300761,43.47460785499425,38.03287472700336,0.0218304391345156,34397646722.0,1
1676,2016-11-29,3269.23,3301.21,3263.4,3282.92,320836287.0,5.920000000000073,0.0,5.920000000000073,82.88041016259231,3148.54,3301.21,88.01991222899066,-11.980087771009336,44.943176946820586,39.41493517096681,0.0242928369515704,34718483009.0,1
1677,2016-11-30,3272.14,3277.27,3239.52,3250.03,243576053.0,-32.88999999999987,32.88999999999987,0.0,60.17286361025889,3166.07,3301.21,62.12816338611818,-37.87183661388182,42.95788860626408,40.12352585802626,0.0129595287444093,34474906956.0,0
1678,2016-12-01,3257.03,3279.67,3256.26,3273.31,237759864.0,23.279999999999745,0.0,23.279999999999745,67.45514795291417,3186.8,3301.21,75.61401975351794,-24.38598024648206,42.77000869720996,40.65282242586301,0.0251968454614357,34712666820.0,1
1679,2016-12-02,3270.12,3279.71,3235.28,3243.84,259567205.0,-29.4699999999998,29.4699999999998,0.0,53.23689244507735,3187.21,3301.21,49.675438596491325,-50.32456140350868,39.78451864085946,40.479161668862304,0.0079828472880381,34453099615.0,0
1680,2016-12-05,3203.78,3219.52,3194.88,3204.71,223010394.0,-39.13000000000011,39.13000000000011,0.0,40.24164486101859,3187.21,3301.21,15.350877192982455,-84.64912280701753,33.870593170604025,39.15744796921065,-0.0134345129065525,34230089221.0,0
1681,2016-12-06,3202.03,3215.31,3196.52,3199.65,157572693.0,-5.059999999999945,5.059999999999945,0.0,38.82748125722628,3187.21,3301.21,10.912280701754437,-89.08771929824557,28.44753938997019,37.01546625336256,-0.0128010514818859,34072516528.0,0
1682,2016-12-07,3198.47,3222.43,3189.49,3222.24,169072847.0,22.58999999999969,0.0,22.58999999999969,48.20385647005563,3187.5,3301.21,30.551402691055998,-69.448597308944,25.676570879331397,34.747687178556326,-0.0060152880860279,34241589375.0,1
1683,2016-12-08,3225.55,3228.12,3211.47,3215.37,170710173.0,-6.869999999999891,6.869999999999891,0.0,45.74350868420426,3188.28,3301.21,23.98831134330977,-76.01168865669023,22.66493947208573,32.33113763726221,-0.0142767800756605,34070879202.0,0
1684,2016-12-09,3209.34,3244.8,3207.04,3232.88,204023956.0,17.51000000000022,0.0,17.51000000000022,52.82470532242999,3189.49,3301.21,38.83816684568585,-61.16183315431415,21.443918404049327,30.15369379061963,-0.0134635337198657,34274903158.0,1
1685,2016-12-12,3233.67,3245.09,3149.9,3152.97,274708461.0,-79.91000000000031,79.91000000000031,0.0,31.3080765304301,3149.9,3301.21,2.0289471945011632,-97.97105280549884,13.86831593303441,26.89661821910259,-0.039583663324114,34000194697.0,0
1686,2016-12-13,3138.99,3162.5,3118.71,3155.04,185164495.0,2.070000000000164,0.0,2.070000000000164,32.13431329157413,3118.71,3301.21,19.90684931506845,-80.09315068493154,7.940099570466828,23.10531448937544,-0.0292274225160998,34185359192.0,1
1687,2016-12-14,3149.38,3170.02,3136.35,3140.53,201358887.0,-14.509999999999764,14.509999999999764,0.0,29.285305906146377,3118.71,3301.21,11.956164383561733,-88.04383561643827,2.047507268506706,18.89375304520169,-0.0405644439420647,33984000305.0,0
1688,2016-12-15,3125.76,3138.78,3100.91,3117.68,189990626.0,-22.850000000000364,22.850000000000364,0.0,25.222070488942165,3100.91,3301.21,8.372441337992994,-91.627558662007,-4.415321540932837,14.231938127974786,-0.0388921771727336,33794009679.0,0
1689,2016-12-16,3111.51,3128.87,3106.35,3122.98,164988699.0,5.300000000000182,0.0,5.300000000000182,27.89938125337089,3100.91,3301.21,11.018472291562729,-88.98152770843727,-9.005682328488547,9.58441403668212,-0.0255030876428756,33958998378.0,1
1690,2016-12-19,3120.7,3125.28,3110.08,3118.08,154169716.0,-4.900000000000091,4.900000000000091,0.0,26.872997936976844,3100.91,3279.71,9.602908277404952,-90.39709172259504,-12.89037317539396,5.089456594266903,-0.0254934133420843,33804828662.0,0
1691,2016-12-20,3115.9,3117.01,3084.8,3102.88,157426759.0,-15.199999999999818,15.199999999999818,0.0,23.746169897489168,3084.8,3279.71,9.276076137704552,-90.72392386229544,-16.999571153163743,0.6716510447807723,-0.0370425542479764,33647401903.0,0
1692,2016-12-21,3107.24,3140.25,3107.24,3137.43,186706607.0,34.54999999999973,0.0,34.54999999999973,41.57550717314214,3084.8,3279.71,27.0022061464264,-72.9977938535736,-17.26917559554022,-2.916514283283427,-0.0242398230996744,33834108510.0,1
1693,2016-12-22,3132.16,3143.17,3126.89,3139.56,167804990.0,2.130000000000109,0.0,2.130000000000109,42.5313446017532,3084.8,3245.09,34.163079418553735,-65.83692058144626,-17.113689895458265,-5.755949405718396,-0.0288659028482344,34001913500.0,1
1694,2016-12-23,3134.93,3138.4,3103.75,3110.15,166176769.0,-29.40999999999985,29.40999999999985,0.0,33.73771651146032,3084.8,3245.09,15.8150851581508,-84.1849148418492,-19.142939675788057,-8.433347459732328,-0.0135808459959972,33835736731.0,0
1695,2016-12-26,3095.58,3122.88,3068.42,3122.57,152571881.0,12.420000000000073,0.0,12.420000000000073,39.80245703538613,3068.42,3245.09,30.65036508745122,-69.34963491254878,-19.523885347832675,-10.6514550373524,-0.0102914701556873,33988308612.0,1
1696,2016-12-27,3117.39,3127.88,3113.75,3114.66,141528939.0,-7.910000000000309,7.910000000000309,0.0,37.29410325517696,3068.42,3245.09,26.17309107375319,-73.8269089262468,-20.230849787777515,-12.567333987437424,-0.0082374631033615,33846779673.0,0
1697,2016-12-28,3113.77,3118.78,3094.55,3102.24,135727087.0,-12.420000000000073,12.420000000000073,0.0,33.472385648434724,3068.42,3245.09,19.1430350370746,-80.8569649629254,-21.544957542290376,-14.36285869840802,-0.0049524005029381,33711052586.0,0
1698,2016-12-29,3095.84,3111.8,3087.34,3096.1,132623292.0,-6.139999999999873,6.139999999999873,0.0,31.62384992991126,3068.42,3245.09,15.667628912661929,-84.33237108733807,-22.818803132950507,-16.054047585316518,-0.0086071636705966,33578429294.0,0
1699,2016-12-30,3097.35,3108.84,3089.99,3103.64,133267130.0,7.539999999999964,0.0,7.539999999999964,36.586077518973056,3068.42,3170.02,34.665354330708496,-65.3346456692915,-22.955305483092616,-17.43429916487174,-0.0046310550082101,33711696424.0,1
1700,2017-01-03,3105.31,3136.46,3105.31,3135.92,141567187.0,32.2800000000002,0.0,32.2800000000002,53.320431592822935,3068.42,3170.02,66.4370078740158,-33.562992125984195,-20.225610110889196,-17.99256135407523,0.0106481720208322,33853263611.0,1
1701,2017-01-04,3133.79,3160.1,3130.11,3158.79,167860850.0,22.86999999999989,0.0,22.86999999999989,61.60358270890599,3068.42,3160.1,98.57111692844684,-1.4288830715531715,-16.032081142799598,-17.600465311820106,0.0068081200218013,34021124461.0,1
1702,2017-01-05,3157.91,3168.5,3154.28,3165.41,174727645.0,6.619999999999891,0.0,6.619999999999891,63.75187808683718,3068.42,3168.5,96.91247002398067,-3.0875299760193324,-12.035759801500715,-16.487524209756227,0.008233637834601,34195852106.0,1
1703,2017-01-06,3163.78,3172.03,3153.03,3154.32,183708966.0,-11.08999999999969,11.08999999999969,0.0,57.53003062113385,3068.42,3172.03,82.90705530354211,-17.092944696457884,-9.652251516420163,-15.120469671089014,0.0142018873687763,34012143140.0,0
1704,2017-01-09,3148.53,3173.14,3147.74,3171.24,171714075.0,16.919999999999618,0.0,16.919999999999618,63.75688381805911,3068.42,3173.14,98.18563789152014,-1.8143621084798456,-6.325089737324106,-13.361393684336033,0.0155865200780125,34183857215.0,1
1705,2017-01-10,3167.57,3174.58,3157.33,3161.67,179759216.0,-9.569999999999707,9.569999999999707,0.0,58.18903634071477,3068.42,3174.58,87.83911077618701,-12.160889223812992,-4.409677064387779,-11.571050360346382,0.0150931401822349,34004097999.0,0
1706,2017-01-11,3156.69,3167.03,3136.27,3136.75,178362221.0,-24.920000000000076,24.920000000000076,0.0,46.09440868748859,3068.42,3174.58,64.3651092690279,-35.634890730972096,-4.8466651176217965,-10.226173311801466,0.0111242199185106,33825735778.0,0
1707,2017-01-12,3133.6,3144.97,3115.98,3119.29,148889240.0,-17.460000000000036,17.460000000000036,0.0,39.46326472433297,3068.42,3174.58,47.918236623963786,-52.08176337603621,-6.526622536905961,-9.486263156822366,0.0074900681502536,33676846538.0,0
1708,2017-01-13,3116.08,3130.51,3102.16,3112.76,156274214.0,-6.529999999999745,6.529999999999745,0.0,37.15655724076253,3068.42,3174.58,41.7671439336852,-58.2328560663148,-8.28936270828899,-9.246883067115691,0.0029384851335851,33520572324.0,0
1709,2017-01-16,3104.49,3105.14,3044.29,3103.43,257885996.0,-9.330000000000382,9.330000000000382,0.0,33.890705312387794,3044.29,3174.58,45.39105073298019,-54.60894926701981,-10.320234777511814,-9.461553409194916,-0.0103605959335698,33262686328.0,0
1710,2017-01-17,3087.03,3108.91,3072.34,3108.77,136157861.0,5.3400000000001455,0.0,5.3400000000001455,37.517531332986486,3044.29,3174.58,49.489600122803004,-50.510399877197,-11.367781443967488,-9.842799016149431,-0.0158351773938755,33398844189.0,1
1711,2017-01-18,3104.77,3123.72,3098.59,3113.01,131780128.0,4.2400000000002365,0.0,4.2400000000002365,40.50771165854892,3044.29,3174.58,52.74387903906691,-47.25612096093309,-11.720727904080832,-10.218384793735712,-0.0165539377205479,33530624317.0,1
1712,2017-01-19,3104.97,3115.78,3094.01,3101.3,123851420.0,-11.710000000000036,11.710000000000036,0.0,35.147600179000506,3044.29,3174.58,43.75623608872533,-56.24376391127467,-12.797814413809649,-10.7342707177505,-0.0168086941083973,33406772897.0,0
1713,2017-01-20,3095.82,3125.66,3095.21,3123.14,122366777.0,21.83999999999969,0.0,21.83999999999969,49.52179845928705,3044.29,3174.58,60.51884258193256,-39.48115741806744,-11.753619349763994,-10.9381404441532,-0.0151675685220922,33529139674.0,1
1714,2017-01-23,3125.42,3145.84,3125.42,3136.77,132660392.0,13.63000000000011,0.0,13.63000000000011,56.46951669523053,3044.29,3174.58,70.98012126794077,-29.01987873205922,-9.714279976511534,-10.693368350624867,-0.0078755847384451,33661800066.0,1
1715,2017-01-24,3134.59,3149.53,3131.22,3142.55,125973881.0,5.7800000000002,0.0,5.7800000000002,59.21618408481041,3044.29,3174.58,75.41637884718723,-24.583621152812768,-7.544720296881223,-10.06363873987614,0.001849047581095,33787773947.0,1
1716,2017-01-25,3137.65,3151.47,3133.19,3149.55,112073827.0,7.0,0.0,7.0,62.52080008895601,3044.29,3174.58,80.78900913347168,-19.210990866528324,-5.200538550197962,-9.091018701940504,0.0097009255311304,33899847774.0,1
1717,2017-01-26,3149.22,3163.1,3148.91,3159.17,113876772.0,9.61999999999989,0.0,9.61999999999989,66.7880881378245,3044.29,3174.58,88.17253818405108,-11.827461815948928,-2.537256115614128,-7.780266184675229,0.0149095979131059,34013724546.0,1
1718,2017-02-03,3160.08,3162.68,3136.01,3140.17,92224736.0,-19.0,19.0,0.0,53.0287014440439,3044.29,3174.58,73.58968454985045,-26.410315450149564,-1.9373937396221663,-6.611691695664617,0.0118385141601389,33921499810.0,0
1719,2017-02-06,3143.09,3158.84,3135.39,3156.98,127198283.0,16.809999999999945,0.0,16.809999999999945,61.19072142450215,3044.29,3167.03,91.81196024116004,-8.188039758839956,-0.104368872510804,-5.310227131033855,0.0155077410036768,34048698093.0,1
1720,2017-02-07,3154.4,3159.54,3140.04,3153.09,128337442.0,-3.8899999999998727,3.8899999999998727,0.0,58.47750930575833,3044.29,3163.1,91.57478326740193,-8.42521673259807,1.0226377199269336,-4.043654160841697,0.012874998795378,33920360651.0,0
1721,2017-02-08,3148.09,3167.45,3132.03,3166.98,144920187.0,13.889999999999873,0.0,13.889999999999873,64.89128366048337,3044.29,3167.45,99.61838259175072,-0.3816174082492696,3.002000289843181,-2.634523270704721,0.0211782155870119,34065280838.0,1
1722,2017-02-09,3164.69,3186.84,3162.57,3183.18,191640327.0,16.199999999999818,0.0,16.199999999999818,70.93335515727185,3044.29,3186.84,97.4324798316378,-2.567520168362192,5.810879792885316,-0.9454426579867132,0.0192242422689985,34256921165.0,1
1723,2017-02-10,3183.01,3205.05,3182.8,3196.7,239348913.0,13.519999999999982,0.0,13.519999999999982,75.06554587563004,3072.34,3205.05,93.70808529877148,-6.291914701228514,9.023866528398685,1.048419179290367,0.019105640515562,34496270078.0,1
1724,2017-02-13,3198.99,3219.41,3198.99,3216.84,220191508.0,20.140000000000327,0.0,20.140000000000327,79.96189868157467,3094.01,3219.41,97.95055821371632,-2.0494417862836656,13.044937429117,3.447722829255694,0.0236400375491241,34716461586.0,1
1725,2017-02-14,3216.14,3219.4,3205.29,3217.93,188798088.0,1.0899999999996908,0.0,1.0899999999996908,80.20464412727429,3094.01,3219.41,98.81977671451354,-1.1802232854864612,16.13364041481873,5.984906346368302,0.0217110380848055,34905259674.0,1
1726,2017-02-15,3215.46,3236.0,3206.56,3212.99,241507706.0,-4.940000000000055,4.940000000000055,0.0,75.42642146610731,3095.21,3236.0,83.65650969529071,-16.343490304709302,17.975631182364395,8.383051313567522,0.0170361202467734,34663751968.0,0
1727,2017-02-16,3210.36,3230.28,3207.79,3229.62,216955942.0,16.63000000000011,0.0,16.63000000000011,80.04433916509099,3125.42,3236.0,94.23042141436056,-5.769578585639459,20.54054553092783,10.814550157039584,0.0284857189260454,34880707910.0,1
1728,2017-02-17,3227.71,3238.4,3199.42,3202.08,226228177.0,-27.539999999999964,27.539999999999964,0.0,58.89575241114007,3131.22,3238.4,66.11308079865641,-33.886919201343595,20.119090441843127,12.675458214000296,0.0142858047881202,34654479733.0,0
1729,2017-02-20,3198.96,3241.46,3198.96,3239.96,232152096.0,37.88000000000011,0.0,37.88000000000011,71.03946045441334,3132.03,3241.46,98.62926071461207,-1.3707392853879212,22.58137958353564,14.656642487907368,0.0275507518022002,34886631829.0,1
1730,2017-02-21,3242.22,3254.34,3239.88,3253.33,211673066.0,13.36999999999989,0.0,13.36999999999989,74.14973648106769,3132.03,3254.34,99.17422941705485,-0.8257705829451548,25.319738545448672,16.78926169941563,0.0272657231810746,35098304895.0,1
1731,2017-02-22,3252.69,3261.38,3243.84,3261.22,207453776.0,7.889999999999873,0.0,7.889999999999873,75.91130318337012,3132.03,3261.38,99.87630459992243,-0.1236954000775487,27.806034158965304,18.992616191325563,0.0245163641390055,35305758671.0,1
1732,2017-02-23,3258.83,3264.08,3236.35,3251.38,209179800.0,-9.83999999999969,9.83999999999969,0.0,69.13208267502657,3132.03,3264.08,90.38243089738748,-9.61756910261253,28.65215141560748,20.924523236181948,0.0171051396752901,35096578871.0,0
1733,2017-02-24,3246.86,3253.96,3233.53,3253.43,186406362.0,2.049999999999727,0.0,2.049999999999727,69.7808108932381,3132.03,3264.08,91.9348731541082,-8.065126845891793,29.15207631564681,22.57003385207492,0.011374516606359,35282985233.0,1
1734,2017-02-27,3249.19,3251.65,3224.09,3228.66,182581071.0,-24.769999999999985,24.769999999999985,0.0,53.96792228791699,3132.03,3264.08,73.17682695948493,-26.82317304051507,27.235583558519465,23.503143793363837,0.0033344417063143,35100404162.0,0
1735,2017-02-28,3225.97,3242.68,3225.97,3241.73,151244318.0,13.070000000000164,0.0,13.070000000000164,59.54881796242435,3162.57,3264.08,77.98246478179493,-22.017535218205065,26.46630195611442,24.095775425913956,0.0089449391376881,35251648480.0,1
1736,2017-03-01,3240.07,3259.98,3237.87,3246.93,190677550.0,5.199999999999818,0.0,5.199999999999818,61.68150641086205,3182.8,3264.08,78.90009842519667,-21.09990157480333,25.97679298606954,24.471978937945075,0.0053597636873687,35442326030.0,1
1737,2017-03-02,3250.52,3256.81,3228.66,3230.03,181215076.0,-16.899999999999636,16.899999999999636,0.0,51.49955649307925,3198.96,3264.08,47.71191646191679,-52.28808353808321,23.94909458519578,24.36740206739522,0.0087287013441264,35261110954.0,0
1738,2017-03-03,3219.2,3221.16,3206.61,3218.31,157082368.0,-11.720000000000256,11.720000000000256,0.0,45.49075394220672,3198.96,3264.08,29.714373464373374,-70.28562653562662,21.15258906217377,23.724439466350933,-0.0066821812614971,35104028586.0,0
1739,2017-03-06,3217.33,3234.66,3215.07,3233.87,156092158.0,15.559999999999944,0.0,15.559999999999944,53.7562250327789,3198.96,3264.08,53.60872235872223,-46.391277641277775,19.96179312177537,22.97191019743582,-0.0059815635057003,35260120744.0,1
1740,2017-03-07,3233.09,3242.66,3226.82,3242.41,164064235.0,8.539999999999964,0.0,8.539999999999964,57.8078162813206,3198.96,3264.08,66.7229729729728,-33.277027027027195,19.48260207876501,22.274048573701663,-0.0057677801558925,35424184979.0,1
1741,2017-03-08,3240.53,3245.3,3230.61,3240.66,160731388.0,-1.75,1.75,0.0,56.63458892066971,3198.96,3264.08,64.03562653562636,-35.96437346437364,18.74554240599264,21.56834734015986,-0.0032970615554012,35263453591.0,0
1742,2017-03-09,3233.7,3233.88,3205.28,3216.75,167371108.0,-23.90999999999985,23.90999999999985,0.0,42.906546493446704,3198.96,3264.08,27.318796068796058,-72.68120393120394,16.0470991591651,20.46409770396091,-0.0112742551706966,35096082483.0,0
1743,2017-03-10,3213.73,3222.32,3208.45,3212.76,136672743.0,-3.9899999999997817,3.9899999999997817,0.0,40.99325773604924,3205.28,3264.08,12.72108843537424,-87.27891156462576,13.431770699010483,19.057632302970827,-0.004924643660218,34959409740.0,0
1744,2017-03-13,3209.45,3237.12,3193.16,3237.02,163673760.0,24.259999999999764,0.0,24.259999999999764,55.05413728937313,3193.16,3264.08,61.84433164128608,-38.15566835871393,13.164926227961132,17.879091087968888,-0.0014529279119482,35123083500.0,1
1745,2017-03-14,3235.25,3246.33,3231.52,3239.33,146946022.0,2.309999999999945,0.0,2.309999999999945,56.20082683251473,3193.16,3264.08,65.10152284263962,-34.89847715736037,12.990105901891638,16.90129405075344,-0.002340672573785,35270029522.0,1
1746,2017-03-15,3235.4,3243.71,3227.74,3241.76,144055682.0,2.430000000000291,0.0,2.430000000000291,57.51641362118624,3193.16,3259.98,72.73271475606143,-27.26728524393857,12.89894916890944,16.100825074384638,0.0036315452178463,35414085204.0,1
1747,2017-03-16,3247.16,3269.77,3247.16,3268.94,189416002.0,27.17999999999984,0.0,27.17999999999984,69.3846050649336,3193.16,3269.77,98.91659052343046,-1.0834094765695417,14.84873863259645,15.850407786027,0.0157318592677524,35603501206.0,1
1748,2017-03-17,3271.87,3274.19,3232.28,3237.45,200583223.0,-31.49000000000024,31.49000000000024,0.0,50.51841508840676,3193.16,3274.19,54.65876835739832,-45.34123164260168,13.695112273575887,15.41934868353678,0.0011070327502342,35402917983.0,0
1749,2017-03-20,3241.11,3251.13,3228.12,3250.81,170548430.0,13.360000000000127,0.0,13.360000000000127,56.33107941819262,3193.16,3274.19,71.14648895470806,-28.85351104529193,13.70095928831961,15.075670804493347,0.0025906655851666,35573466413.0,1
1750,2017-03-21,3250.25,3262.22,3246.7,3261.61,162719306.0,10.800000000000182,0.0,10.800000000000182,60.64343024724158,3193.16,3274.19,84.47488584474898,-15.525114155251012,14.41094245612885,14.94272513482045,0.0064647324927638,35736185719.0,1
1751,2017-03-22,3246.22,3255.78,3229.13,3245.22,189731649.0,-16.390000000000327,16.390000000000327,0.0,51.70296389369528,3193.16,3274.19,64.24780945328868,-35.75219054671132,13.495505422861244,14.653281192428608,0.0088505479132663,35546454070.0,0
1752,2017-03-23,3245.81,3262.09,3221.93,3248.55,193029144.0,3.330000000000382,0.0,3.330000000000382,53.31640778736762,3193.16,3274.19,68.35739849438504,-31.64260150561497,12.890128768046452,14.300650707552176,0.0111399544317036,35739483214.0,1
1753,2017-03-24,3247.35,3275.21,3241.12,3269.45,219777914.0,20.89999999999964,0.0,20.89999999999964,62.4103405435271,3193.16,3275.21,92.97989031078583,-7.020109689214145,13.936171232017388,14.22775481244522,0.0100184737814408,35959261128.0,1
1754,2017-03-27,3268.92,3283.24,3262.12,3266.96,201852675.0,-2.4899999999997817,2.4899999999997817,0.0,60.78266376223145,3193.16,3283.24,81.92717584369477,-18.07282415630524,14.398270926216355,14.261858035199444,0.0085295416027388,35757408453.0,0
1755,2017-03-28,3265.63,3265.63,3246.09,3252.95,161710013.0,-14.010000000000218,14.010000000000218,0.0,51.98137839506911,3193.16,3283.24,66.37433392539965,-33.62566607460034,13.478625149008169,14.10521145796119,0.0034518286362961,35595698440.0,0
1756,2017-03-29,3252.87,3262.1,3233.28,3241.31,216105575.0,-11.639999999999873,11.639999999999873,0.0,45.64524043908444,3193.16,3283.24,53.45248667850814,-46.54751332149186,11.675955378842444,13.61936024213744,-0.0084522811675956,35379592865.0,0
1757,2017-03-30,3235.14,3240.02,3195.85,3210.24,247135479.0,-31.070000000000164,31.070000000000164,0.0,33.18649318334131,3193.16,3283.24,18.96092362344576,-81.03907637655425,7.65202942923861,12.425894079557674,-0.0084047630079229,35132457386.0,0
1758,2017-03-31,3206.25,3226.25,3205.54,3222.51,196442922.0,12.270000000000437,0.0,12.270000000000437,40.577158077107335,3195.85,3283.24,30.50692298890073,-69.49307701109927,5.390981697449206,11.01891160313598,-0.0087055226235921,35328900308.0,1
1759,2017-04-05,3235.66,3270.65,3233.24,3270.31,248320202.0,47.79999999999973,0.0,47.79999999999973,60.3112730284343,3195.85,3283.24,85.2042567799521,-14.795743220047894,7.3711752785548015,10.289364338219746,0.0026673943236621,35577220510.0,1
1760,2017-04-06,3272.19,3286.67,3265.76,3281.0,245287999.0,10.690000000000056,0.0,10.690000000000056,63.44398719805621,3195.85,3286.67,93.75688174410917,-6.243118255890842,9.691370531232678,10.169765576822334,0.0110254466569292,35822508509.0,1
1761,2017-04-07,3280.62,3295.19,3275.05,3286.62,236108942.0,5.619999999999891,0.0,5.619999999999891,65.11433579162335,3195.85,3295.19,91.37306221058974,-8.62693778941026,11.847063443942716,10.505225150246412,0.0117190746640807,36058617451.0,1
1762,2017-04-10,3285.46,3285.46,3265.01,3269.39,232694616.0,-17.230000000000018,17.230000000000018,0.0,56.0538656790248,3195.85,3295.19,74.02858868532299,-25.971411314677013,12.026514433171997,10.80948300683153,-1.8351710532327203e-05,35825922835.0,0
1763,2017-04-11,3266.22,3290.39,3244.4,3288.97,281281248.0,19.579999999999927,0.0,19.579999999999927,62.83475207328431,3195.85,3295.19,93.73867525669394,-6.261324743306066,13.591992963957182,11.36598499825666,0.0067371501334574,36107204083.0,1
1764,2017-04-12,3283.84,3284.93,3262.28,3273.83,269381790.0,-15.139999999999873,15.139999999999873,0.0,55.23127942964151,3195.85,3295.19,78.49808737668603,-21.501912623313967,13.455863687916462,11.783960736188622,0.0064187890991254,35837822293.0,0
1765,2017-04-13,3265.22,3281.14,3261.49,3275.96,207346875.0,2.130000000000109,0.0,2.130000000000109,56.09374177718589,3195.85,3295.19,80.6422387759211,-19.357761224078917,13.365781050701116,12.100324799091124,0.010690122203677,36045169168.0,1
1766,2017-04-14,3276.14,3276.71,3238.9,3246.07,214508558.0,-29.889999999999876,29.889999999999876,0.0,42.7565982551384,3195.85,3295.19,50.55365411717353,-49.44634588282648,10.758499428373398,11.83195972494758,0.0111611592902711,35830660610.0,0
1767,2017-04-17,3229.95,3229.95,3199.91,3222.17,212737189.0,-23.90000000000009,23.90000000000009,0.0,35.06462878311066,3195.85,3295.19,26.494866116368154,-73.50513388363184,6.686600727935456,10.802887925545155,-0.0001055078184396,35617923421.0,0
1768,2017-04-18,3215.4,3225.05,3196.49,3196.71,188661353.0,-25.46000000000004,25.46000000000004,0.0,28.714960530151203,3195.85,3295.19,0.8657137104893557,-99.13428628951064,1.3891689742822564,8.920144135292576,-0.022505511709899,35429262068.0,0
1769,2017-04-19,3184.67,3189.44,3147.07,3170.69,213238075.0,-26.019999999999985,26.019999999999985,0.0,23.66215211474052,3147.07,3295.19,15.946529840669664,-84.05347015933033,-4.852741020452413,6.165567104143578,-0.0336208473026515,35216023993.0,0
1770,2017-04-20,3165.67,3178.18,3148.18,3172.1,190873985.0,1.4099999999998545,0.0,1.4099999999998545,24.492905451749664,3147.07,3295.19,16.898460707534273,-83.10153929246573,-9.575345819511767,3.0173845194125084,-0.0348443081341925,35406897978.0,1
1771,2017-04-21,3170.29,3180.79,3158.63,3173.15,164761740.0,1.050000000000182,0.0,1.050000000000182,25.19241861154643,3147.07,3295.19,17.60734539562513,-82.39265460437487,-13.082510880660266,-0.2025945606020472,-0.0294366839073955,35571659718.0,1
1772,2017-04-24,3164.25,3164.25,3111.21,3129.53,186277434.0,-43.61999999999989,43.61999999999989,0.0,17.44541567303999,3111.21,3295.19,9.957604087400892,-90.0423959125991,-19.1608594512968,-3.994247538740999,-0.0484771828262342,35385382284.0,0
1773,2017-04-25,3123.89,3145.27,3117.45,3134.57,153418307.0,5.039999999999964,0.0,5.039999999999964,20.696649283676532,3111.21,3295.19,12.697032286118125,-87.30296771388187,-23.302689705199555,-7.855935972032713,-0.0425373339483112,35538800591.0,1
1774,2017-04-26,3132.92,3152.95,3131.42,3140.85,169878107.0,6.279999999999745,0.0,6.279999999999745,24.946326537785424,3111.21,3295.19,16.110446787694244,-83.88955321230576,-25.781187029992907,-11.440986183624752,-0.0412428723183433,35708678698.0,1
1775,2017-04-27,3131.35,3155.0,3097.33,3152.19,211793073.0,11.340000000000146,0.0,11.340000000000146,32.484548245664115,3097.33,3290.39,28.416036465347634,-71.58396353465236,-26.524611577566706,-14.457711262413149,-0.0289211261617895,35920471771.0,1
1776,2017-04-28,3144.02,3154.73,3136.58,3154.66,162889899.0,2.4699999999998,0.0,2.4699999999998,34.14683300935984,3097.33,3290.39,29.69543147208119,-70.3045685279188,-26.60775489458274,-16.887719988847067,-0.0209517188726852,36083361670.0,1
1777,2017-05-02,3147.23,3154.78,3136.54,3143.71,154222962.0,-10.949999999999818,10.949999999999818,0.0,30.32737187160997,3097.33,3284.93,24.72281449893397,-75.27718550106603,-27.243177665525764,-18.958811524182806,-0.0165795458455725,35929138708.0,0
1778,2017-05-03,3138.31,3148.29,3123.75,3135.35,163763924.0,-8.360000000000127,8.360000000000127,0.0,27.60709881742123,3097.33,3281.14,20.684402372014578,-79.31559762798543,-28.097447042582644,-20.78653862786277,-0.0111458389183427,35765374784.0,0
1779,2017-05-04,3127.11,3143.82,3111.39,3127.37,177967485.0,-7.980000000000018,7.980000000000018,0.0,25.124951905024812,3097.33,3276.71,16.74657152413867,-83.25342847586134,-29.08312878195784,-22.44585665868179,-0.0141010686926641,35587407299.0,0
1780,2017-05-05,3114.77,3117.61,3092.09,3103.04,176213641.0,-24.329999999999927,24.329999999999927,0.0,19.087614025726992,3092.09,3229.95,7.942840562889774,-92.05715943711024,-31.464809588795102,-24.24964724470445,-0.0220947638781652,35411193658.0,0
1781,2017-05-08,3090.07,3093.45,3067.69,3078.61,180526904.0,-24.42999999999984,24.42999999999984,0.0,14.930859964521131,3067.69,3225.05,6.939501779359471,-93.06049822064053,-34.92105740510624,-26.383929276784816,-0.0162708138282745,35230666754.0,0
1782,2017-05-09,3064.85,3084.21,3056.56,3080.53,135066674.0,1.9200000000000728,0.0,1.9200000000000728,16.578291718638027,3056.56,3189.44,18.03883202889843,-81.96116797110157,-37.077820709565,-28.52270756334086,-0.0172400042111039,35365733428.0,1
1783,2017-05-10,3078.17,3090.82,3051.59,3052.78,160794452.0,-27.75,27.75,0.0,12.531237541764796,3051.59,3180.79,0.9210526315789908,-99.078947368421,-40.558728475627504,-30.929911745798183,-0.028040180205995,35204938976.0,0
1784,2017-05-11,3036.79,3063.56,3016.53,3061.5,191341901.0,8.7199999999998,0.0,8.7199999999998,19.643708868556075,3016.53,3180.79,27.37732862534997,-72.62267137465003,-42.128115147322205,-33.169552426103,-0.0287704738610299,35396280877.0,1
1785,2017-05-12,3054.11,3090.49,3051.87,3083.51,159684099.0,22.01000000000022,0.0,22.01000000000022,35.02994076448334,3016.53,3164.25,45.34253994042791,-54.657460059572095,-41.12181564340926,-34.76000506956425,-0.0225539360818597,35555964976.0,1
1786,2017-05-15,3085.93,3098.91,3085.93,3090.23,135660728.0,6.7199999999998,0.0,6.7199999999998,39.1355111893724,3016.53,3155.0,53.22452516790636,-46.77547483209365,-39.32871129540536,-35.67374631473248,-0.0170117472667644,35691625704.0,1
1787,2017-05-16,3082.87,3113.51,3060.53,3112.96,173775564.0,22.730000000000015,0.0,22.730000000000015,51.17661274703857,3016.53,3155.0,69.63963313353071,-30.36036686646929,-35.66244764616613,-35.67148658101921,-0.0071411485161145,35865401268.0,1
1788,2017-05-17,3107.8,3119.58,3101.3,3104.44,168674158.0,-8.519999999999982,8.519999999999982,0.0,47.1428860241949,3016.53,3155.0,63.486675814255776,-36.51332418574422,-33.06326732102343,-35.14984272902006,-0.0073320393813332,35696727110.0,0
1789,2017-05-18,3082.33,3103.44,3077.96,3090.14,148620035.0,-14.300000000000182,14.300000000000182,0.0,40.89978566731185,3016.53,3154.78,53.24412296564172,-46.755877034358285,-31.79082384894764,-34.47803895300557,-0.0041572135712075,35548107075.0,0
1790,2017-05-19,3086.71,3095.48,3081.28,3090.63,129635230.0,0.4900000000002364,0.0,0.4900000000002364,41.2076172401935,3016.53,3154.78,53.59855334538872,-46.40144665461128,-30.39251829277464,-33.66093482095938,0.0039043594349397,35677742305.0,1
1791,2017-05-22,3087.17,3103.94,3063.15,3075.68,153683730.0,-14.950000000000273,14.950000000000273,0.0,34.82239817133224,3016.53,3148.29,44.89222829386744,-55.10777170613256,-30.14321885938807,-32.95739162864512,-0.001574404404437,35524058575.0,0
1792,2017-05-23,3069.39,3084.24,3050.84,3061.95,178310599.0,-13.730000000000018,13.730000000000018,0.0,29.91098699306292,3016.53,3143.82,35.68230025925024,-64.31769974074976,-30.69965698013129,-32.505844698942354,0.003003819469467,35345747976.0,0
1793,2017-05-24,3047.57,3064.81,3022.3,3064.08,139813353.0,2.130000000000109,0.0,2.130000000000109,31.636928825794115,3016.53,3119.58,46.14264919941762,-53.85735080058238,-30.61584460202357,-32.1278446795586,0.0008427241548261,35485561329.0,1
1794,2017-05-25,3055.34,3114.66,3052.83,3107.83,191391841.0,43.75,0.0,43.75,56.83086109158285,3016.53,3119.58,88.59776807375057,-11.402231926249424,-26.71125262940905,-31.04452626952869,0.0078871156571569,35676953170.0,1
1795,2017-05-26,3101.29,3120.66,3100.39,3110.06,155923486.0,2.230000000000018,0.0,2.230000000000018,57.74668069711949,3016.53,3120.66,89.82041678670898,-10.179583213291023,-23.169805897253354,-29.46958219507362,0.006416998087521,35832876656.0,1
1796,2017-05-31,3125.33,3143.28,3111.56,3117.18,152950430.0,7.119999999999891,0.0,7.119999999999891,60.80962439475901,3016.53,3143.28,79.40828402366836,-20.59171597633165,-19.563147564113933,-27.48829526888169,0.0013556229440789,35985827086.0,1
1797,2017-06-01,3108.42,3113.52,3097.68,3102.62,163015719.0,-14.559999999999944,14.559999999999944,0.0,51.92770898805814,3016.53,3143.28,67.92110453648891,-32.078895463511095,-17.675957729727998,-25.525827761050948,-0.0005862571027303,35822811367.0,0
1798,2017-06-02,3094.23,3110.39,3081.85,3105.54,142504925.0,2.9200000000000728,0.0,2.9200000000000728,53.49938278380975,3022.3,3143.28,68.8047611175399,-31.195238882460103,-15.763020307006173,-23.573266270241994,0.0049835929763699,35965316292.0,1
1799,2017-06-05,3102.11,3105.51,3084.83,3091.66,132570300.0,-13.88000000000011,13.88000000000011,0.0,45.36470738870805,3022.3,3143.28,57.33179037857469,-42.668209621425305,-15.191881069181363,-21.89698923002987,0.0003332653860215,35832745992.0,0
1800,2017-06-06,3084.54,3102.86,3078.79,3102.13,113439963.0,10.470000000000256,0.0,10.470000000000256,51.75016999295483,3022.3,3143.28,65.98611340717467,-34.01388659282533,-13.736066782347734,-20.26480474049345,0.0085997242886126,35946185955.0,1
1801,2017-06-07,3101.76,3140.77,3098.95,3140.32,173229014.0,38.190000000000055,0.0,38.190000000000055,67.65863609762573,3022.3,3143.28,97.5533145974541,-2.446685402545905,-9.39243944329246,-18.09033168105325,0.025594800698901,36119414969.0,1
1802,2017-06-08,3136.47,3153.26,3132.83,3150.33,152277659.0,10.009999999999764,0.0,10.009999999999764,70.59116724017935,3022.3,3153.26,97.76267562614515,-2.237324373854834,-5.083757745248477,-15.489016893892297,0.0281487428526669,36271692628.0,1
1803,2017-06-09,3147.45,3165.92,3146.11,3158.4,160136334.0,8.070000000000164,0.0,8.070000000000164,72.87877211664468,3022.3,3165.92,94.76396045119066,-5.236039548809349,-1.0063147311652756,-12.592476461346893,0.0162718037987921,36431828962.0,1
1804,2017-06-12,3149.53,3164.95,3135.31,3139.88,146729425.0,-18.519999999999985,18.519999999999985,0.0,60.43131532451783,3022.3,3165.92,81.86882049853781,-18.13117950146218,0.722352185636737,-9.929510731950169,0.0095882394551873,36285099537.0,0
1805,2017-06-13,3134.01,3155.99,3131.04,3153.74,128318279.0,13.859999999999673,0.0,13.859999999999673,65.51705457686964,3022.3,3165.92,91.51928700738038,-8.48071299261962,3.1741299445479854,-7.308782596650536,0.0117285495223247,36413417816.0,1
1806,2017-06-14,3146.75,3149.17,3125.35,3130.67,138347042.0,-23.06999999999971,23.06999999999971,0.0,52.54602103375552,3022.3,3165.92,75.45606461495612,-24.543935385043884,3.218524143758259,-5.203321248568777,0.0090407462080435,36275070774.0,0
1807,2017-06-15,3125.59,3137.59,3117.08,3132.49,146954245.0,1.819999999999709,0.0,1.819999999999709,53.38607576812508,3052.83,3165.92,70.43947298611704,-29.56052701388297,3.361812771131099,-3.490294444628802,0.008678039890003,36422025019.0,1
1808,2017-06-16,3126.37,3134.25,3117.86,3123.17,129652758.0,-9.319999999999707,9.319999999999707,0.0,48.33073135782455,3078.79,3165.92,50.93538390910141,-49.0646160908986,2.692288900598669,-2.2537777755833077,0.0101919357238506,36292372261.0,0
1809,2017-06-19,3122.16,3146.77,3121.78,3144.37,134891758.0,21.199999999999815,0.0,21.199999999999815,58.61614095878755,3078.79,3165.92,75.26684264891523,-24.733157351084763,3.828219897751751,-1.0373782409162953,0.0136164506323073,36427264019.0,1
1810,2017-06-20,3148.02,3150.46,3134.61,3140.01,141191802.0,-4.359999999999673,4.359999999999673,0.0,55.972150954206256,3078.79,3165.92,70.26282566280291,-29.73717433719709,4.3267616203334,0.0354497313336441,-9.871605441480467e-05,36286072217.0,0
1811,2017-06-21,3148.99,3157.03,3132.62,3156.21,136688268.0,16.199999999999818,0.0,16.199999999999818,63.106699912548535,3078.79,3165.92,88.85573281303796,-11.144267186962038,5.960356854602651,1.220431155987446,0.0018664711315958,36422760485.0,1
1812,2017-06-22,3152.24,3186.98,3146.64,3147.45,191344006.0,-8.760000000000218,8.760000000000218,0.0,57.31211310489487,3078.79,3186.98,63.46242721138721,-36.53757278861279,6.473511447211877,2.2710472142323326,-0.0034669452887539,36231416479.0,0
1813,2017-06-23,3138.44,3158.05,3118.09,3157.87,154843648.0,10.420000000000073,0.0,10.420000000000073,62.08976984745917,3078.79,3186.98,73.09363157408254,-26.90636842591747,7.633008504700228,3.343439472325912,0.005729518325541,36386260127.0,1
1814,2017-06-26,3157.0,3187.89,3156.98,3185.44,173579211.0,27.570000000000164,0.0,27.570000000000164,71.74433592747513,3098.95,3187.89,97.24533393298874,-2.754666067011262,10.653776757664671,4.805506929393665,0.0100515578329223,36559839338.0,1
1815,2017-06-27,3183.42,3193.46,3172.46,3191.2,148201198.0,5.759999999999764,0.0,5.759999999999764,73.37866601652989,3117.08,3193.46,97.041110238282,-2.9588897617180088,13.35855214950243,6.51611597341542,0.0193345194479135,36708040536.0,1
1816,2017-06-28,3183.63,3193.44,3170.79,3173.2,146516720.0,-18.0,18.0,0.0,60.71575425304575,3117.08,3193.46,73.47473160513198,-26.52526839486801,13.889546520320891,7.990802082796515,0.0129960510648079,36561523816.0,0
1817,2017-06-29,3174.98,3188.77,3174.28,3188.06,128755470.0,14.860000000000127,0.0,14.860000000000127,66.26176095975224,3117.08,3193.46,92.93008641005488,-7.06991358994512,15.33269542600101,9.459180751437415,0.0207769669918704,36690279286.0,1
1818,2017-06-30,3176.95,3193.24,3171.57,3192.43,121464543.0,4.369999999999891,0.0,4.369999999999891,67.8040770349318,3117.08,3193.46,98.6514794448806,-1.3485205551194013,16.63724006234861,10.894792613619655,0.0152844607981885,36811743829.0,1
1819,2017-07-03,3192.0,3196.29,3177.02,3195.91,140305717.0,3.480000000000018,0.0,3.480000000000018,69.10193730480454,3117.08,3196.29,99.5202625931068,-0.4797374068932066,17.747327853648585,12.265299661625445,0.017802491074869,36952049546.0,1
1820,2017-07-04,3192.89,3193.06,3174.31,3182.8,141114967.0,-13.109999999999673,13.109999999999673,0.0,58.79885272227688,3117.08,3196.29,82.96932205529633,-17.03067794470367,17.368994039382414,13.28603853717684,0.0084246612234293,36810934579.0,0
1821,2017-07-05,3179.22,3207.31,3174.71,3207.13,148296483.0,24.329999999999927,0.0,24.329999999999927,68.76984718841064,3117.86,3207.31,99.7987702627168,-0.2012297372832159,18.815496104680733,14.39193005067762,0.0189613814357656,36959231062.0,1
1822,2017-07-06,3203.86,3215.95,3188.77,3212.44,175809287.0,5.309999999999945,0.0,5.309999999999945,70.56380083538892,3118.09,3215.95,96.4132434089518,-3.586756591048207,20.15796357914769,15.545136756371637,0.017280635364977,37135040349.0,1
1823,2017-07-07,3203.82,3219.52,3195.29,3217.96,176715416.0,5.519999999999982,0.0,5.519999999999982,72.46126490115421,3118.09,3219.52,98.46199349304943,-1.538006506950555,21.420375833170056,16.720184571731323,0.0102089507258023,37311755765.0,1
1824,2017-07-10,3208.46,3223.34,3203.21,3212.63,198928010.0,-5.329999999999927,5.329999999999927,0.0,67.60599815808692,3118.09,3223.34,89.82422802850353,-10.175771971496472,21.740153230673517,17.72417830351976,0.0067153421910253,37112827755.0,0
1825,2017-07-11,3201.52,3226.91,3199.22,3203.04,187837262.0,-9.590000000000146,9.590000000000146,0.0,59.35003964470249,3118.09,3226.91,78.0646939900754,-21.93530600992461,20.9779257987384,18.374927802563487,0.0094037564603555,36924990493.0,0
1826,2017-07-12,3201.93,3215.2,3177.93,3197.54,186900880.0,-5.5,5.5,0.0,54.91246944514063,3118.09,3226.91,73.01047601543836,-26.989523984561632,19.70292794410261,18.640527830871317,0.0029735952271914,36738089613.0,0
1827,2017-07-13,3192.36,3219.27,3190.34,3218.16,195303611.0,20.61999999999989,0.0,20.61999999999989,65.93164812578351,3156.98,3226.91,87.48748748748746,-12.512512512512542,20.12436349452628,18.93729496360231,0.0080596912070116,36933393224.0,1
1828,2017-07-14,3212.03,3222.98,3204.85,3222.42,160126773.0,4.260000000000218,0.0,4.260000000000218,67.80716446311777,3170.79,3226.91,91.99928724162548,-8.000712758374537,20.56503962668694,19.26284389621924,0.0082949770175004,37093519997.0,1
1829,2017-07-17,3219.79,3230.35,3139.5,3176.46,266205274.0,-45.96000000000004,45.96000000000004,0.0,40.23420134233904,3139.5,3230.35,40.6824435883325,-59.3175564116675,17.009614492320452,18.81219801543948,-0.001991956767626,36827314723.0,0
1830,2017-07-18,3159.73,3187.67,3150.13,3187.57,190623060.0,11.110000000000127,0.0,11.110000000000127,46.322325423100494,3139.5,3230.35,52.91139240506353,-47.08860759493648,14.91645104525469,18.033048621402525,-0.0060989108642306,37017937783.0,1
1831,2017-07-19,3181.4,3232.94,3179.73,3230.98,272420726.0,43.409999999999854,0.0,43.409999999999854,63.21571294078045,3139.5,3232.94,97.90239726027391,-2.097602739726065,16.56942611042814,17.74032411920765,0.0057713140167598,37290358509.0,1
1832,2017-07-20,3227.51,3246.24,3225.43,3244.86,232108392.0,13.88000000000011,0.0,13.88000000000011,67.04242580912447,3139.5,3246.24,98.70713884204642,-1.2928611579535854,18.7829031431379,17.9488399239937,0.0083593332421783,37522466901.0,1
1833,2017-07-21,3236.59,3247.71,3231.96,3237.98,206003251.0,-6.880000000000109,6.880000000000109,0.0,63.2774729775467,3139.5,3247.71,91.00822474817484,-8.991775251825167,19.754226708444094,18.309917280883777,0.0078907312700187,37316463650.0,0
1834,2017-07-24,3230.9,3261.1,3230.07,3250.6,233056399.0,12.61999999999989,0.0,12.61999999999989,67.17856510520195,3139.5,3261.1,91.36513157894736,-8.634868421052639,21.296839453815664,18.907301715470155,0.0148483940256756,37549520049.0,1
1835,2017-07-25,3249.14,3261.65,3233.14,3243.69,205573873.0,-6.909999999999855,6.909999999999855,0.0,62.9534387196632,3139.5,3261.65,85.29676627097828,-14.703233729021717,21.7115150867553,19.468144389727183,0.0144329703459535,37343946176.0,0
1836,2017-07-26,3244.46,3264.85,3228.04,3247.67,213542005.0,3.980000000000018,0.0,3.980000000000018,64.43980566373699,3139.5,3264.85,86.29437574790599,-13.705624252094015,22.10647160730105,19.99580983324196,0.0091698361796803,37557488181.0,1
1837,2017-07-27,3243.76,3251.93,3220.64,3249.78,228485945.0,2.1100000000001278,0.0,2.1100000000001278,65.29164838038437,3139.5,3264.85,87.97766254487458,-12.022337455125424,22.33230396263116,20.4631086591198,0.0084905133409052,37785974126.0,1
1838,2017-07-28,3240.17,3256.37,3232.96,3253.24,182226880.0,3.4599999999995816,0.0,3.4599999999995816,66.7965895832029,3139.5,3264.85,90.73793378540076,-9.262066214599232,22.53075034971198,20.87663699723824,0.0241715620533549,37968201006.0,1
1839,2017-07-31,3252.75,3276.95,3251.19,3273.03,246039440.0,19.79000000000042,0.0,19.79000000000042,74.18399829677756,3139.5,3276.95,97.14805383775946,-2.851946162240541,24.00815705925106,21.502941009640804,0.0268103916149291,38214240446.0,1
1840,2017-08-01,3274.37,3292.64,3273.5,3292.64,237194594.0,19.609999999999676,0.0,19.609999999999676,79.41937272485461,3139.5,3292.64,100.0,-0.0,26.45640269140631,22.493633345993903,0.0190839930918791,38451435040.0,1
1841,2017-08-02,3288.52,3305.43,3282.04,3285.06,266730628.0,-7.579999999999927,7.579999999999927,0.0,72.83188477204226,3139.5,3305.43,87.7237389260532,-12.276261073946792,27.468374024958848,23.4885814817869,0.0123888241711507,38184704412.0,0
1842,2017-08-03,3279.99,3293.37,3262.16,3272.93,233277004.0,-12.13000000000011,12.13000000000011,0.0,63.15876601498493,3139.5,3305.43,80.41342734888204,-19.58657265111796,26.98056382731511,24.186977950892544,0.0107937664840425,37951427408.0,0
1843,2017-08-04,3269.32,3287.19,3261.31,3262.08,275906340.0,-10.849999999999907,10.849999999999907,0.0,55.54488806714216,3150.13,3305.43,72.08628461043143,-27.91371538956857,25.42537847215499,24.43465805514504,0.0035316556943334,37675521068.0,0
1844,2017-08-07,3257.67,3280.1,3243.72,3279.46,231173379.0,17.38000000000011,0.0,17.38000000000011,63.64520353222525,3179.73,3305.43,79.33969769291977,-20.66030230708022,25.30361925119223,24.60845029435448,0.0110275642863528,37906694447.0,1
1845,2017-08-08,3277.19,3285.48,3269.66,3281.87,252043537.0,2.4099999999998545,0.0,2.4099999999998545,64.67506030848091,3220.64,3305.43,72.2137044462791,-27.786295553720908,25.112114229056715,24.709183081294928,0.010530626572281,38158737984.0,1
1846,2017-08-09,3277.81,3277.94,3263.85,3275.57,235597907.0,-6.299999999999727,6.299999999999727,0.0,59.58391424642239,3220.64,3305.43,64.78358296969019,-35.216417030309806,24.173332639303226,24.60201299289659,0.007935921816246,37923140077.0,0
1847,2017-08-10,3269.73,3282.52,3236.18,3261.75,240684622.0,-13.820000000000164,13.820000000000164,0.0,49.684394688913805,3220.64,3305.43,48.48449109564824,-51.51550890435176,22.059890281071603,24.093588450531595,0.0026158537335088,37682455455.0,0
1848,2017-08-11,3237.92,3245.12,3200.75,3208.54,262962995.0,-53.21000000000004,53.21000000000004,0.0,28.58537982995236,3200.75,3305.43,7.441727168513541,-92.55827283148643,15.907992247915445,22.45646921000837,-0.019703455208171,37419492460.0,0
1849,2017-08-14,3206.04,3240.05,3206.04,3237.36,190346796.0,28.820000000000164,0.0,28.820000000000164,43.56332450548272,3200.75,3305.43,34.97325181505558,-65.02674818494441,13.205872794611423,20.60634992692898,-0.016788959619029,37609839256.0,1
1850,2017-08-15,3235.23,3263.59,3235.1,3251.26,182297997.0,13.900000000000093,0.0,13.900000000000093,49.46196798993703,3200.75,3305.43,48.25181505540724,-51.74818494459276,12.04716527085884,18.894512995714955,-0.0102890053758529,37792137253.0,1
1851,2017-08-16,3247.85,3248.78,3228.87,3246.45,176852051.0,-4.8100000000004,4.8100000000004,0.0,47.48051256574559,3200.75,3305.43,43.65685899885354,-56.343141001146456,10.618352649447845,17.239280926461532,-0.0080906099427729,37615285202.0,0
1852,2017-08-17,3253.85,3269.14,3251.46,3268.43,203622551.0,21.980000000000015,0.0,21.980000000000015,56.639330263355234,3200.75,3305.43,64.65418418035912,-35.34581581964086,11.13129600703769,16.017683942576763,0.0019466107514223,37818907753.0,1
1853,2017-08-18,3253.24,3275.08,3248.08,3268.72,191122483.0,0.2899999999999636,0.0,0.2899999999999636,56.75414078296145,3200.75,3305.43,64.93121895299953,-35.06878104700047,11.42945623298965,15.10003840065934,-0.0032749294091101,38010030236.0,1
1854,2017-08-21,3274.58,3287.52,3270.48,3286.91,186122483.0,18.19000000000005,0.0,18.19000000000005,63.70871645964576,3200.75,3305.43,82.3079862437906,-17.69201375620941,12.983861467191671,14.67680301396581,0.0015357098239723,38196152719.0,1
1855,2017-08-22,3287.61,3293.48,3274.94,3290.23,186537991.0,3.320000000000164,0.0,3.320000000000164,64.89753882310399,3200.75,3293.48,96.49520112153564,-3.5047988784643582,14.31857939749534,14.605158290671715,0.00447555692597,38382690710.0,1
1856,2017-08-23,3283.8,3299.46,3274.44,3287.7,179832208.0,-2.5300000000002,2.5300000000002,0.0,63.08059799625501,3200.75,3299.46,88.08631344341991,-11.913686556580098,14.999300517848496,14.683986736107071,0.0079558519199816,38202858502.0,0
1857,2017-08-24,3287.96,3297.99,3266.36,3271.51,163468937.0,-16.1899999999996,16.1899999999996,0.0,52.27433964209648,3200.75,3299.46,71.68473305642812,-28.31526694357189,14.070186859801195,14.561226760845898,0.0196257487829356,38039389565.0,0
1858,2017-08-25,3271.46,3331.91,3271.46,3331.52,205839482.0,60.00999999999976,0.0,60.00999999999976,72.45531198149126,3200.75,3331.91,99.70265324794154,-0.2973467520584577,17.969027305949112,15.24278686986654,0.0290854276323917,38245229047.0,1
1859,2017-08-28,3336.13,3375.03,3336.13,3362.65,257461438.0,31.13000000000011,0.0,31.13000000000011,78.01877732824464,3200.75,3375.03,92.896488409456,-7.103511590544007,23.30220398249276,16.854670292391784,0.0342605635968824,38502690485.0,1
1860,2017-08-29,3362.06,3374.59,3354.46,3365.23,219504535.0,2.5799999999999272,0.0,2.5799999999999272,78.43530074978327,3200.75,3375.03,94.37686481523974,-5.623135184760255,27.42087854123793,18.967911942161013,0.0365876572871906,38722195020.0,1
1861,2017-08-30,3361.82,3376.65,3357.08,3363.63,246863312.0,-1.599999999999909,1.599999999999909,0.0,77.38600433656299,3200.75,3376.65,92.59806708357024,-7.401932916429775,30.20763634605328,21.215856822939468,0.0291271344345755,38475331708.0,0
1862,2017-08-31,3361.46,3367.36,3340.69,3360.81,234419781.0,-2.820000000000164,2.820000000000164,0.0,75.33640695297723,3206.04,3376.65,90.71566731141192,-9.284332688588083,31.821789767534028,23.33704341185838,0.028173107516092,38240911927.0,0
1863,2017-09-01,3365.99,3381.93,3358.47,3367.12,282497584.0,6.309999999999945,0.0,6.309999999999945,76.91497953795187,3228.87,3381.93,90.32405592578075,-9.675944074219228,33.22716022860823,25.315066775208354,0.0244028586118878,38523409511.0,1
1864,2017-09-04,3369.72,3381.4,3359.13,3379.58,267427849.0,12.460000000000036,0.0,12.460000000000036,79.85300218701398,3228.87,3381.93,98.4646543839018,-1.5353456160982033,34.943536969009074,27.240760813968507,0.0271561562565534,38790837360.0,1
1865,2017-09-05,3377.2,3390.82,3371.57,3384.32,216552946.0,4.7400000000002365,0.0,4.7400000000002365,80.91894862470129,3248.08,3390.82,95.44626593806922,-4.5537340619307765,36.26817929303888,29.046244509782586,0.0293883261854792,39007390306.0,1
1866,2017-09-06,3372.43,3391.01,3364.76,3385.39,229090785.0,1.069999999999709,0.0,1.069999999999709,81.17832867566447,3248.08,3391.01,96.06800531728796,-3.9319946827120495,36.97804801650318,30.6326052111267,0.0348096139091733,39236481091.0,1
1867,2017-09-07,3383.63,3387.8,3363.18,3365.5,221118685.0,-19.889999999999876,19.889999999999876,0.0,62.85275753835607,3266.36,3391.01,79.53469715202552,-20.46530284797449,35.526144047519665,31.61131297840529,0.0101995485544135,39015362406.0,0
1868,2017-09-08,3364.43,3380.89,3353.69,3365.24,198405184.0,-0.2600000000002183,0.2600000000002183,0.0,62.63947661854073,3266.36,3391.01,79.3261131167265,-20.6738868832735,33.96301536472674,32.08165345566958,0.0007702258635302,38816957222.0,0
1869,2017-09-11,3365.35,3384.81,3360.05,3376.42,219011019.0,11.180000000000293,0.0,11.180000000000293,68.02316068176948,3266.36,3391.01,88.29522663457671,-11.704773365423293,33.24315083701413,32.31395293193849,0.0033251813397598,39035968241.0,1
1870,2017-09-12,3381.49,3391.07,3370.85,3379.49,272910319.0,3.069999999999709,0.0,3.069999999999709,69.41939148763257,3266.36,3391.07,90.71445754149596,-9.285542458504032,32.5452153712904,32.36020541980887,0.0047151440556778,39308878560.0,1
1871,2017-09-13,3374.72,3387.14,3366.54,3384.15,194550715.0,4.660000000000309,0.0,4.660000000000309,71.59188991826755,3271.46,3391.07,94.21453055764565,-5.785469442354373,31.999252081947816,32.28801475223666,0.0069447543895668,39503429275.0,1
1872,2017-09-14,3383.47,3391.64,3361.33,3371.43,221306487.0,-12.720000000000256,12.720000000000256,0.0,58.502069727671326,3336.13,3391.64,63.59214555935845,-36.40785444064154,30.19213836999052,31.868839475787432,0.001280025659911,39282122788.0,0
1873,2017-09-15,3365.15,3365.53,3345.33,3353.62,219765816.0,-17.809999999999945,17.809999999999945,0.0,45.16177152286914,3340.69,3391.64,25.377821393522837,-74.62217860647718,27.011497845009217,30.897371149631795,-0.0076814278697353,39062356972.0,0
1874,2017-09-18,3352.51,3371.75,3352.51,3362.86,190319676.0,9.240000000000236,0.0,9.240000000000236,51.74838420766347,3340.69,3391.64,43.51324828263033,-56.48675171736968,24.94881369757377,29.707659659220187,-0.0063410079425113,39252676648.0,1
1875,2017-09-19,3365.53,3370.4,3344.71,3356.84,191129691.0,-6.019999999999982,6.019999999999982,0.0,47.462850153817655,3340.69,3391.64,31.69774288518184,-68.30225711481816,22.56820573365621,28.279768874107397,-0.0084332971976639,39061546957.0,0
1876,2017-09-20,3352.18,3370.1,3346.54,3366.0,192196661.0,9.159999999999854,0.0,9.159999999999854,54.131924573346176,3344.71,3391.64,45.36543788621359,-54.63456211378641,21.17658176496161,26.85913145227824,0.0001485663348685,39253743618.0,1
1877,2017-09-21,3364.7,3377.88,3356.88,3357.81,197448695.0,-8.190000000000055,8.190000000000055,0.0,47.86373687973178,3344.71,3391.64,27.91391434050704,-72.08608565949297,19.19161618532962,25.325628398888515,-0.0022078663037405,39056294923.0,0
1878,2017-09-22,3347.16,3356.45,3334.98,3352.53,179234007.0,-5.279999999999745,5.279999999999745,0.0,44.0678898108842,3334.98,3391.64,30.97423226261953,-69.02576773738048,16.996539264702278,23.65981057205127,-0.0070755415499256,38877060916.0,0
1879,2017-09-25,3344.59,3350.96,3334.94,3341.55,169621293.0,-10.980000000000018,10.980000000000018,0.0,37.0227842482801,3334.94,3391.64,11.657848324515252,-88.34215167548474,14.20715946347309,21.76928035033564,-0.0112265460172983,38707439623.0,0
1880,2017-09-26,3336.35,3347.16,3332.6,3343.58,132628595.0,2.0299999999997453,0.0,2.0299999999997453,39.09973425205633,3332.6,3391.64,18.5975609756098,-81.4024390243902,12.02178030908044,19.8197803420846,-0.0119882392919935,38840068218.0,1
1881,2017-09-27,3340.82,3349.69,3340.3,3345.27,143086945.0,1.6900000000000546,0.0,1.6900000000000546,40.96979389919446,3332.6,3391.64,21.46002710027114,-78.53997289972887,10.307403133313528,17.917304900330386,-0.0077593187460512,38983155163.0,1
1882,2017-09-28,3343.84,3344.6,3336.18,3339.64,149444300.0,-5.630000000000109,5.630000000000109,0.0,36.64450849979142,3332.6,3391.64,11.924119241192358,-88.07588075880764,8.397650039668406,16.01337392819799,-0.0041686297195269,38833710863.0,0
1883,2017-09-29,3340.31,3357.02,3340.31,3348.94,144862443.0,9.300000000000182,0.0,9.300000000000182,47.25742565588235,3332.6,3391.64,27.67615176151788,-72.32384823848213,7.547585364708539,14.320216215500098,-0.0041393337813646,38978573306.0,1
1884,2017-10-09,3403.25,3410.17,3366.97,3374.38,191736057.0,25.44000000000005,0.0,25.44000000000005,65.49905331690873,3332.6,3410.17,53.86102874822755,-46.138971251772446,8.824969618062823,13.221166896012644,0.0052251522264987,39170309363.0,1
1885,2017-10-10,3373.34,3384.03,3358.8,3382.99,179423841.0,8.609999999999673,0.0,8.609999999999673,69.60437582600427,3332.6,3410.17,64.96068067551859,-35.03931932448142,10.412037399260043,12.659340996662126,0.0050475341651812,39349733204.0,1
1886,2017-10-11,3381.49,3395.78,3379.16,3388.28,181476704.0,5.290000000000418,0.0,5.290000000000418,71.96896566559971,3332.6,3410.17,71.78032744617788,-28.21967255382213,11.95880517769865,12.519233832869432,0.0090743669236794,39531209908.0,1
1887,2017-10-12,3385.53,3390.2,3372.53,3386.1,161809380.0,-2.180000000000291,2.180000000000291,0.0,69.40174117173525,3332.6,3410.17,68.96996261441264,-31.03003738558736,12.86047446077555,12.587481958450658,0.0100133332140204,39369400528.0,0
1888,2017-10-13,3384.49,3395.75,3383.24,3390.52,139954764.0,4.420000000000073,0.0,4.420000000000073,71.7585244741902,3332.6,3410.17,74.66804176872496,-25.33195823127504,13.772944987849767,12.82457456433048,0.0146548757313222,39509355292.0,1
1889,2017-10-16,3393.21,3400.51,3374.77,3378.47,174330620.0,-12.050000000000182,12.050000000000182,0.0,57.7630989451947,3332.6,3410.17,59.13368570323552,-40.86631429676448,13.369633349655489,12.933586321395484,0.0104349230465548,39335024672.0,0
1890,2017-10-17,3373.23,3382.41,3365.56,3372.04,125381725.0,-6.429999999999836,6.429999999999836,0.0,51.57033669244232,3332.6,3410.17,50.84439860770913,-49.15560139229087,12.388353480988826,12.824539753314154,0.0080023436075413,39209642947.0,0
1891,2017-10-18,3373.53,3383.23,3371.92,3381.79,157228791.0,9.75,0.0,9.75,59.219708900176485,3332.6,3410.17,63.413690859868446,-36.586309140131554,12.25614442740698,12.71086068813272,0.0126211208393718,39366871738.0,1
1892,2017-10-19,3374.64,3378.74,3359.63,3370.17,158476495.0,-11.61999999999989,11.61999999999989,0.0,48.65232745812092,3332.6,3410.17,48.4336728116541,-51.56632718834591,11.085939107052129,12.385876371916604,0.0063393193070047,39208395243.0,0
1893,2017-10-20,3363.51,3379.77,3360.1,3378.65,127172851.0,8.480000000000018,0.0,8.480000000000018,55.3598802266236,3332.6,3410.17,59.36573417558345,-40.63426582441655,10.719243324927447,12.052549762518774,0.0012654176470936,39335568094.0,1
1894,2017-10-23,3382.28,3385.29,3374.71,3380.7,130846289.0,2.049999999999727,0.0,2.049999999999727,56.929272318328216,3336.18,3410.17,60.17029328287585,-39.82970671712416,10.473322204175927,11.736704250850206,-0.0006769159826071,39466414383.0,1
1895,2017-10-24,3376.6,3388.69,3374.12,3388.25,139897511.0,7.550000000000182,0.0,7.550000000000182,62.527603367350046,3336.18,3410.17,70.37437491552913,-29.62562508447088,10.763574064507338,11.542078213581634,-8.85404984241056e-06,39606311894.0,1
1896,2017-10-25,3384.86,3398.3,3382.03,3396.9,123131222.0,8.650000000000091,0.0,8.650000000000091,68.02226689516007,3340.31,3410.17,81.00486687661042,-18.99513312338957,11.558346045513645,11.545331779968038,0.0031895100558165,39729443116.0,1
1897,2017-10-26,3397.52,3414.24,3391.45,3407.57,183768625.0,10.670000000000073,0.0,10.670000000000073,73.5437330619471,3358.8,3414.24,87.96897546897607,-12.03102453102393,12.900479693931176,11.816361362760668,0.0050287271568962,39913211741.0,1
1898,2017-10-27,3404.5,3421.1,3402.11,3416.81,170257173.0,9.239999999999782,0.0,9.239999999999782,77.4365784696671,3358.8,3421.1,93.1139646869984,-6.886035313001577,14.54208890914242,12.36150687203702,0.0113483322332299,40083468914.0,1
1899,2017-10-30,3413.87,3419.73,3357.28,3390.34,208349286.0,-26.4699999999998,26.4699999999998,0.0,52.09771443043394,3357.28,3421.1,51.80194296458806,-48.19805703541194,13.550961212693435,12.599397740168303,0.0054269818863359,39875119628.0,0
1900,2017-10-31,3381.0,3397.1,3376.12,3393.34,153498206.0,3.0,0.0,3.0,54.06340435873904,3357.28,3421.1,56.50266374177391,-43.497336258226085,12.859325995102608,12.651383391155168,0.0034153510419039,40028617834.0,1
1901,2017-11-01,3393.97,3410.35,3388.6,3395.91,180566127.0,2.569999999999709,0.0,2.569999999999709,55.85404908668447,3357.28,3421.1,60.529614540896006,-39.470385459104,12.375915770550364,12.596289867034208,0.0076375969164759,40209183961.0,1
1902,2017-11-02,3391.65,3391.65,3372.21,3383.31,166864267.0,-12.599999999999907,12.599999999999907,0.0,45.762731212705305,3357.28,3421.1,40.78658727671555,-59.213412723284456,10.8510112838444,12.247234150396247,0.0013792491083717,40042319694.0,0
1903,2017-11-03,3377.74,3380.57,3347.36,3371.74,172714790.0,-11.570000000000164,11.570000000000164,0.0,38.410006226862166,3347.36,3421.1,33.06211011662562,-66.9378898833744,8.609664335184789,11.519720187353958,-0.0026503386872541,39869604904.0,0
1904,2017-11-06,3369.69,3389.38,3356.53,3388.17,154636468.0,16.43000000000029,0.0,16.43000000000029,51.24528064480708,3347.36,3421.1,55.34309736913489,-44.65690263086511,8.066162716318104,10.829008693146788,-2.361100863279564e-05,40024241372.0,1
1905,2017-11-07,3389.47,3415.15,3387.95,3413.57,190571746.0,25.40000000000009,0.0,25.40000000000009,64.45774960903809,3347.36,3421.1,89.78844589096859,-10.211554109031418,9.5746311036296,10.578133175243352,0.0049074155847979,40214813118.0,1
1906,2017-11-08,3409.15,3434.49,3404.88,3415.46,185436470.0,1.889999999999873,0.0,1.889999999999873,65.26591305078799,3347.36,3434.49,78.15907265006334,-21.84092734993667,10.798136180826988,10.62213377636008,0.0023154329918386,40400249588.0,1
1907,2017-11-09,3410.67,3428.77,3408.62,3427.79,158650426.0,12.329999999999927,0.0,12.329999999999927,70.34216233722535,3347.36,3434.49,92.3103408699646,-7.689659130035401,12.617256840388109,11.021158389165686,0.0032135237253461,40558900014.0,1
1908,2017-11-10,3423.18,3438.79,3414.33,3432.67,189276503.0,4.880000000000109,0.0,4.880000000000109,72.1977106454959,3347.36,3438.79,93.30635458820966,-6.6936454117903335,14.28799517092284,11.67452574551712,0.012485473433343,40748176517.0,1
1909,2017-11-13,3435.18,3449.16,3435.08,3447.84,205389054.0,15.170000000000073,0.0,15.170000000000073,77.29335795412783,3347.36,3449.16,98.7033398821221,-1.29666011787791,16.644294487769912,12.66847949396768,0.0160608721790329,40953565571.0,1
1910,2017-11-14,3446.55,3450.49,3419.69,3429.55,196472674.0,-18.289999999999964,18.289999999999964,0.0,61.589639639470896,3347.36,3450.49,79.69552991370146,-20.30447008629853,16.841688032447564,13.503121201663657,0.009906034023281,40757092897.0,0
1911,2017-11-15,3416.21,3423.75,3396.38,3402.52,168792076.0,-27.0300000000002,27.0300000000002,0.0,45.74224037176794,3347.36,3450.49,53.48589159313492,-46.51410840686509,14.64817370953233,13.732131703237393,0.0056778716700509,40588300821.0,0
1912,2017-11-16,3393.19,3409.65,3390.59,3399.25,156684332.0,-3.269999999999982,3.269999999999982,0.0,44.15627965552194,3347.36,3450.49,50.31513623581891,-49.68486376418109,12.5018229014413,13.486069942878173,0.0081589920931033,40431616489.0,0
1913,2017-11-17,3392.68,3403.29,3373.3,3382.91,249458153.0,-16.340000000000146,16.340000000000146,0.0,36.799763007688654,3347.36,3450.49,34.47105594880233,-65.52894405119767,9.374262320726755,12.66370841844789,-0.0015524604727626,40182158336.0,0
1914,2017-11-20,3361.36,3393.11,3337.12,3392.4,176524683.0,9.490000000000236,0.0,9.490000000000236,43.14713786321103,3337.12,3450.49,48.76069506924253,-51.23930493075747,7.574102181183662,11.645787170995046,-0.0062017184355381,40358683019.0,1
1915,2017-11-21,3382.36,3419.8,3377.6,3410.5,196871803.0,18.09999999999991,0.0,18.09999999999991,53.43830227536628,3337.12,3450.49,64.72611802064054,-35.27388197935946,7.5212803945773885,10.820885815711517,-0.0014522201987433,40555554822.0,1
1916,2017-11-22,3417.33,3442.18,3404.29,3430.46,213567093.0,19.96000000000004,0.0,19.96000000000004,62.15497676739564,3337.12,3450.49,82.33218664549725,-17.667813354502748,8.986433919092633,10.45399543638774,0.0007789275305662,40769121915.0,1
1917,2017-11-23,3425.01,3429.42,3342.33,3351.92,215265393.0,-78.53999999999996,78.53999999999996,0.0,33.59794719804498,3337.12,3450.49,13.05459998235882,-86.94540001764118,3.7666375759736175,9.116523864304916,-0.0235239623966183,40553856522.0,0
1918,2017-11-24,3340.38,3360.75,3328.33,3353.82,159569663.0,1.900000000000091,0.0,1.900000000000091,34.4387515455261,3328.33,3450.49,20.86607727570421,-79.13392272429579,-0.2143041467084003,7.250358262102251,-0.0272692468327996,40713426185.0,1
1919,2017-11-27,3346.66,3347.05,3315.26,3322.23,166439170.0,-31.590000000000146,31.590000000000146,0.0,27.70801254404012,3315.26,3450.49,5.154181764401259,-94.84581823559874,-5.850833369360771,4.630119935809646,-0.0312927351984955,40546987015.0,0
1920,2017-11-28,3311.23,3333.8,3300.78,3333.66,138247799.0,11.429999999999836,0.0,11.429999999999836,33.16164208871753,3300.78,3450.49,21.96246075746426,-78.03753924253573,-9.28844648261429,1.8464066521248583,-0.0202379412905728,40685234814.0,1
1921,2017-11-29,3335.57,3343.06,3305.57,3337.86,183805932.0,4.200000000000273,0.0,4.200000000000273,35.23320830688026,3300.78,3450.49,24.767884576848594,-75.2321154231514,-11.540839132796464,-0.8310425048594069,-0.0180598661469441,40869040746.0,1
1922,2017-11-30,3328.64,3340.92,3306.28,3317.19,156595851.0,-20.670000000000076,20.670000000000076,0.0,29.96021657824004,3300.78,3450.49,10.96119163716512,-89.03880836283487,-14.822903583706193,-3.629414720628765,-0.0194270613170317,40712444895.0,0
1923,2017-12-01,3315.1,3324.52,3302.44,3317.62,139198300.0,0.4299999999998363,0.0,0.4299999999998363,30.21092459935238,3300.78,3450.49,11.248413599625769,-88.75158640037422,-17.191097628337047,-6.341751302170423,-0.022043391109539,40851643195.0,1
1924,2017-12-04,3310.38,3324.0,3304.1,3309.62,148053288.0,-8.0,8.0,0.0,28.05514024060831,3300.78,3442.18,6.25176803394605,-93.74823196605396,-19.488787006570877,-8.971158443050516,-0.02957924058056,40703589907.0,0
1925,2017-12-05,3301.69,3315.74,3300.51,3303.68,208278862.0,-5.940000000000055,5.940000000000055,0.0,26.43881887427112,3300.51,3442.18,2.2375944095430413,-97.76240559045696,-21.54072270739107,-11.485071295918628,-0.0369571427738554,40495311045.0,0
1926,2017-12-06,3291.31,3296.2,3254.61,3293.96,151604452.0,-9.7199999999998,9.7199999999998,0.0,23.8449963515981,3254.61,3442.18,20.97883456842777,-79.02116543157223,-23.67827093216601,-13.923711223168104,-0.0172915821379985,40343706593.0,0
1927,2017-12-07,3283.28,3291.28,3259.16,3272.05,132105900.0,-21.90999999999985,21.90999999999985,0.0,18.99748942598258,3254.61,3442.18,9.297862131470962,-90.70213786852904,-26.830956624714418,-16.505160303477368,-0.0243811534310129,40211600693.0,0
1928,2017-12-08,3264.48,3297.13,3258.76,3289.99,133209314.0,17.9399999999996,0.0,17.9399999999996,32.048602155892624,3254.61,3442.18,18.86229141120633,-81.13770858879367,-27.564132519164104,-18.716954746614714,-0.0097043251069313,40344810007.0,1
1929,2017-12-11,3290.49,3322.67,3288.29,3322.2,131965984.0,32.21000000000004,0.0,32.21000000000004,49.05366382640303,3254.61,3442.18,36.03454710241499,-63.96545289758501,-25.254978219725217,-20.024559441236818,-0.0034376631090152,40476775991.0,1
1930,2017-12-12,3320.31,3320.31,3280.33,3280.81,124604827.0,-41.38999999999987,41.38999999999987,0.0,35.77817306173077,3254.61,3429.42,14.987700932440836,-85.01229906755916,-26.459772107974004,-21.311601974584256,-0.0170917893500626,40352171164.0,0
1931,2017-12-13,3278.4,3304.01,3273.32,3303.04,111998647.0,22.230000000000015,0.0,22.230000000000015,45.00212419507472,3254.61,3360.75,45.62841530054635,-54.371584699453656,-25.3288297456852,-22.11504752880445,-0.0042656585845248,40464169811.0,1
1932,2017-12-14,3302.93,3309.53,3282.57,3292.44,120544235.0,-10.599999999999907,10.599999999999907,0.0,41.70639654867541,3254.61,3347.05,40.92384249242742,-59.07615750757258,-24.999700205480167,-22.691978064139597,-0.0075897782145031,40343625576.0,0
1933,2017-12-15,3287.53,3287.53,3259.39,3266.14,130940618.0,-26.300000000000185,26.300000000000185,0.0,34.47777727962554,3254.61,3343.06,13.035613340870286,-86.96438665912972,-26.55494401067017,-23.464571253445712,-0.0131374598896549,40212684958.0,0
1934,2017-12-18,3268.03,3280.54,3254.18,3267.92,120700389.0,1.7800000000002,0.0,1.7800000000002,35.352790523802625,3254.18,3343.06,15.459045904590706,-84.54095409540929,-27.328825122877333,-24.23742202733204,-0.0108242929097248,40333385347.0,1
1935,2017-12-19,3266.02,3296.94,3266.02,3296.54,115140134.0,28.61999999999989,0.0,28.61999999999989,48.18920650228845,3254.18,3340.92,48.83560064560758,-51.16439935439242,-25.340625707963227,-24.45806276345828,0.000783251769906,40448525481.0,1
1936,2017-12-20,3296.74,3300.21,3276.12,3287.61,137745118.0,-8.929999999999836,8.929999999999836,0.0,44.9741631972754,3254.18,3324.52,47.52630082456671,-52.473699175433296,-24.206502226672,-24.407750656101022,0.0047554285539646,40310780363.0,0
1937,2017-12-21,3281.12,3309.22,3267.4,3300.06,142127927.0,12.449999999999818,0.0,12.449999999999818,50.30744107948172,3254.18,3324.0,65.71183042108278,-34.28816957891721,-22.048923975213256,-23.935985319923475,0.0030607995768985,40452908290.0,1
1938,2017-12-22,3297.69,3307.33,3293.44,3297.06,124047326.0,-3.0,3.0,0.0,48.9873280461912,3254.18,3322.67,62.6076799532778,-37.392320046722205,-20.34656011466677,-23.218100278872136,-0.0075672746974895,40328860964.0,0
1939,2017-12-25,3296.21,3312.3,3270.44,3280.46,146893635.0,-16.59999999999991,16.59999999999991,0.0,41.95779761364995,3254.18,3322.67,38.37056504599228,-61.62943495400772,-20.105146148544463,-22.595509452806603,-0.000106680972077,40181967329.0,0
1940,2017-12-26,3277.84,3307.3,3274.33,3306.12,142434501.0,25.65999999999985,0.0,25.65999999999985,53.78586657656419,3254.18,3322.67,75.83588845086857,-24.16411154913144,-17.63993411071624,-21.60439438438853,0.0009324743266807,40324401830.0,1
1941,2017-12-27,3302.46,3307.08,3270.35,3275.78,162674890.0,-30.33999999999969,30.33999999999969,0.0,42.08529301811414,3254.18,3322.67,31.537450722733663,-68.46254927726633,-17.927760188079446,-20.869067545126715,-0.0050600770249419,40161726940.0,0
1942,2017-12-28,3272.29,3304.1,3263.73,3296.38,175371670.0,20.59999999999991,0.0,20.59999999999991,50.51831134312119,3254.18,3322.67,61.61483428237717,-38.385165717622826,-16.305655146832578,-19.956385065467888,0.0092586355759398,40337098610.0,1
1943,2017-12-29,3295.25,3308.22,3292.77,3307.17,141586836.0,10.789999999999964,0.0,10.789999999999964,54.52062227842595,3254.18,3320.31,80.13004687736299,-19.869953122637003,-13.988214956148113,-18.76275104360393,0.0120106979363019,40478685446.0,1
1944,2018-01-02,3314.03,3349.05,3314.03,3348.33,202278860.0,41.159999999999854,0.0,41.159999999999854,66.46100375831578,3254.18,3349.05,99.24106672288367,-0.7589332771163192,-8.729728026624798,-16.756146440208106,0.015710411522384,40680964306.0,1
1945,2018-01-03,3347.74,3379.92,3345.29,3369.11,213836149.0,20.7800000000002,0.0,20.7800000000002,70.91003069574597,3254.18,3379.92,91.40289486241456,-8.597105137585434,-2.852682961879964,-13.975453744542476,0.0247900450479223,40894800455.0,1
1946,2018-01-04,3371.0,3392.83,3365.3,3385.71,206955288.0,16.59999999999991,0.0,16.59999999999991,74.07938458071149,3254.18,3392.83,94.86476739992796,-5.135232600072042,3.108565256502516,-10.558649944333478,0.0259540735622989,41101755743.0,1
1947,2018-01-05,3386.46,3402.07,3380.25,3391.75,213060681.0,6.039999999999964,0.0,6.039999999999964,75.21315589386231,3254.18,3402.07,93.02184055717078,-6.9781594428292255,8.225456991628562,-6.80182855714107,0.0287195258806329,41314816424.0,1
1948,2018-01-08,3391.55,3412.73,3384.56,3409.48,236165106.0,17.730000000000018,0.0,17.730000000000018,78.41148165680204,3263.73,3412.73,97.81879194630872,-2.1812080536912752,13.555039325511643,-2.730454980610526,0.0393298500820007,41550981530.0,1
1949,2018-01-09,3406.11,3417.23,3403.59,3413.9,191488551.0,4.420000000000073,0.0,4.420000000000073,79.18408812921821,3263.73,3417.23,97.8306188925082,-2.169381107491809,17.92875723011548,1.4013874615346762,0.0326001476050477,41742470081.0,1
1950,2018-01-10,3414.11,3430.21,3398.84,3421.83,209094997.0,7.929999999999836,0.0,7.929999999999836,80.61987785014384,3263.73,3430.21,94.96636232580484,-5.033637674195163,21.783735563008577,5.477857081829458,0.0445848011771241,41951565078.0,1
1951,2018-01-11,3415.58,3426.48,3405.64,3425.34,173812133.0,3.5100000000002183,0.0,3.5100000000002183,81.27935249271371,3263.73,3430.21,97.07472369053346,-2.9252763094665366,24.835770033930658,9.3494396722497,0.0391217032016939,42125377211.0,1
1952,2018-01-12,3423.88,3435.42,3417.98,3428.94,174063404.0,3.599999999999909,0.0,3.599999999999909,82.00405463991223,3263.73,3435.42,96.22575572252316,-3.774244277476857,27.231115901075555,12.925774918014872,0.036820000181424,42299440615.0,1
1953,2018-01-15,3428.95,3442.5,3402.31,3410.49,232009283.0,-18.450000000000276,18.450000000000276,0.0,66.72864788637594,3263.73,3442.5,82.09431112602773,-17.905688873972267,27.325690402102737,15.805758014832444,0.0185644784116261,42067431332.0,0
1954,2018-01-16,3403.47,3437.58,3401.96,3436.59,211475468.0,26.100000000000364,0.0,26.100000000000364,74.4861992571247,3263.73,3442.5,96.69407618727982,-3.3059238127201738,29.17043463621667,18.47869333910929,0.0200290284377773,42278906800.0,1
1955,2018-01-17,3438.58,3465.2,3430.51,3444.67,261045030.0,8.079999999999927,0.0,8.079999999999927,76.447774287544,3263.73,3465.2,89.80989725517459,-10.190102744825415,30.927878869369124,20.968530445161264,0.0174143680350651,42539951830.0,1
1956,2018-01-18,3449.88,3476.55,3448.79,3474.75,220039555.0,30.079999999999927,0.0,30.079999999999927,82.29490097000829,3292.77,3476.55,99.020568070519,-0.979431929480999,34.351883566347624,23.64520106939854,0.0244711432151543,42759991385.0,1
1957,2018-01-19,3481.62,3498.43,3474.29,3487.86,247536733.0,13.110000000000127,0.0,13.110000000000127,84.26001448862061,3314.03,3498.43,94.26789587852508,-5.732104121474908,37.68884583815316,26.453930023149464,0.0229888428733999,43007528118.0,1
1958,2018-01-22,3476.99,3503.39,3475.67,3501.36,217487534.0,13.5,0.0,13.5,86.09390520561729,3345.29,3503.39,98.71600253004443,-1.283997469955564,40.950695528734286,29.35328312426643,0.025618793754943,43225015652.0,1
1959,2018-01-23,3504.34,3547.22,3504.34,3546.5,238705904.0,45.13999999999987,0.0,45.13999999999987,90.40638520216233,3365.3,3547.22,99.60422163588402,-0.3957783641159858,46.64051285863388,32.810729071139924,0.03643372113752,43463721556.0,1
1960,2018-01-24,3553.48,3569.49,3527.11,3559.47,252954496.0,12.9699999999998,0.0,12.9699999999998,91.30077866623594,3380.25,3569.49,94.70513633481296,-5.29486366518706,51.6014750076024,36.56887825843242,0.03915815656256,43716676052.0,1
1961,2018-01-25,3555.17,3571.48,3528.03,3548.31,243413422.0,-11.159999999999854,11.159999999999854,0.0,83.56599691434381,3384.56,3571.48,87.60432270490045,-12.395677295099542,54.0099613065654,40.05709486805902,0.034812507655427,43473262630.0,0
1962,2018-01-26,3535.49,3574.9,3534.2,3558.13,222698295.0,9.820000000000164,0.0,9.820000000000164,84.86759455119356,3398.84,3574.9,90.47483812336704,-9.52516187663296,56.06481568544996,43.25863903153721,0.0432899671308228,43695960925.0,1
1963,2018-01-29,3563.64,3587.03,3510.27,3523.0,236026965.0,-35.13000000000011,35.13000000000011,0.0,63.95810090564072,3398.84,3587.03,65.97587544502886,-34.02412455497114,54.23343588901525,45.45359840303282,0.0251441108773522,43459933960.0,0
1964,2018-01-30,3511.5,3523.05,3484.66,3488.01,186369975.0,-34.98999999999978,34.98999999999978,0.0,49.84463337762642,3401.96,3587.03,46.49592046252775,-53.50407953747225,49.3893242435006,46.24074357112638,0.0125817567430261,43273563985.0,0
1965,2018-01-31,3470.51,3495.45,3454.73,3480.83,207253403.0,-7.180000000000291,7.180000000000291,0.0,47.369679969140165,3401.96,3587.03,42.61630734316736,-57.38369265683264,44.4584752421033,45.88428990532177,0.0017497661702281,43066310582.0,0
1966,2018-02-01,3478.67,3495.09,3424.42,3446.98,260504707.0,-33.84999999999991,33.84999999999991,0.0,37.29591117430563,3401.96,3587.03,24.325930728913352,-75.67406927108665,37.38834026673885,44.18509997760519,-0.0117206539253296,42805805875.0,0
1967,2018-02-02,3419.22,3463.16,3388.86,3462.08,208120551.0,15.099999999999907,0.0,15.099999999999907,43.4823638957822,3388.86,3587.03,36.94807488519946,-63.05192511480053,32.62754118043631,41.87358821817142,-0.0112184979550803,43013926426.0,1
1968,2018-02-05,3411.67,3487.72,3406.24,3487.5,217673754.0,25.420000000000076,0.0,25.420000000000076,52.57166026994911,3388.86,3587.03,49.77544532472112,-50.22455467527889,30.553552823015707,39.60958113914028,-0.0166361201184266,43231600180.0,1
1969,2018-02-06,3418.01,3440.12,3364.22,3370.65,280555477.0,-116.84999999999992,116.84999999999992,0.0,28.37115692330201,3364.22,3587.03,2.885866882096979,-97.11413311790302,19.259077012238777,35.53948031375998,-0.0530472233225732,42951044703.0,0
1970,2018-02-07,3412.74,3425.54,3304.01,3309.26,260939714.0,-61.38999999999987,61.38999999999987,0.0,22.18134552216779,3304.01,3587.03,1.85499258002968,-98.14500741997033,5.293444089124932,29.49027306883297,-0.0673701001321754,42690104989.0,0
1971,2018-02-08,3281.05,3307.16,3225.71,3262.05,201262499.0,-47.21000000000004,47.21000000000004,0.0,18.583710683836543,3225.71,3587.03,10.05756669987826,-89.94243330012173,-9.474655142249958,21.697287426616384,-0.0832122491308636,42488842490.0,0
1972,2018-02-09,3172.85,3180.11,3062.74,3129.85,256389176.0,-132.20000000000027,132.20000000000027,0.0,12.19361816698988,3062.74,3587.03,12.80016784603942,-87.19983215396057,-31.482998925894663,11.061230156114172,-0.1115952313369288,42232453314.0,0
1973,2018-02-12,3128.37,3168.13,3113.61,3154.13,153310831.0,24.2800000000002,0.0,24.2800000000002,18.157368185370476,3062.74,3587.03,17.431192660550508,-82.56880733944949,-46.43035660338319,-0.4370871957853028,-0.0957222026312998,42385764145.0,1
1974,2018-02-13,3176.11,3219.22,3176.11,3184.96,151527597.0,30.829999999999927,0.0,30.829999999999927,25.564440043140223,3062.74,3587.03,23.31152606381967,-76.68847393618033,-55.15275527830045,-11.380220812288336,-0.0849998419917088,42537291742.0,1
1975,2018-02-14,3188.25,3203.5,3171.38,3199.16,100322827.0,14.199999999999818,0.0,14.199999999999818,28.980363592184787,3062.74,3587.03,26.019950790592983,-73.98004920940701,-60.22525845348264,-21.1492283405272,-0.0718948180726317,42637614569.0,1
1976,2018-02-22,3237.57,3269.92,3234.12,3268.56,138730445.0,69.40000000000009,0.0,69.40000000000009,43.58100837174196,3062.74,3587.03,39.25689980735852,-60.74310019264148,-57.97693178499503,-28.514769029420773,-0.0558970329975043,42776345014.0,1
1977,2018-02-23,3275.43,3294.13,3258.49,3289.02,145790368.0,20.46000000000004,0.0,20.46000000000004,47.26871219869897,3062.74,3523.05,49.15817601181812,-50.84182398818188,-53.92257975942812,-33.59633117542224,-0.0569118279569892,42922135382.0,1
1978,2018-02-26,3307.29,3335.99,3281.61,3329.57,188568602.0,40.55000000000018,0.0,40.55000000000018,54.12569895141246,3062.74,3495.45,61.66485637031739,-38.33514362968262,-46.896832961512246,-36.25643153264024,-0.0121875602628572,43110703984.0,1
1979,2018-02-27,3328.67,3328.67,3284.63,3292.07,174219368.0,-37.5,37.5,0.0,47.530530265894456,3062.74,3495.09,53.042673759685485,-46.95732624031452,-43.849346633099685,-37.77501455273213,-0.0051945147857829,42936484616.0,0
1980,2018-02-28,3264.06,3277.83,3239.84,3259.41,151043536.0,-32.66000000000031,32.66000000000031,0.0,42.34538109003047,3062.74,3487.72,46.27747188102971,-53.72252811897029,-43.56736336573204,-38.93348431533212,-0.0008093070308549,42785441080.0,0
1981,2018-03-01,3235.09,3280.15,3228.58,3273.75,159098320.0,14.340000000000146,0.0,14.340000000000146,45.36492281149023,3062.74,3487.72,49.651748317567936,-50.348251682432064,-41.7060105110636,-39.48798955447842,0.0459766442481268,42944539400.0,1
1982,2018-03-02,3248.45,3269.94,3242.27,3254.53,150861063.0,-19.2199999999998,19.2199999999998,0.0,41.96588892409408,3062.74,3440.12,50.821453177169,-49.178546822831,-41.30562282707979,-39.851516208998696,0.0318312815261261,42793678337.0,0
1983,2018-03-05,3255.87,3269.4,3236.72,3256.93,144835988.0,2.399999999999636,0.0,2.399999999999636,42.58570257644325,3062.74,3425.54,53.52535832414552,-46.47464167585448,-40.32975643276677,-39.94716425375231,0.0225968301014769,42938514325.0,1
1984,2018-03-06,3266.49,3290.25,3243.65,3289.64,195358046.0,32.71000000000004,0.0,32.71000000000004,50.84206325721179,3062.74,3335.99,83.03751143641357,-16.962488563586426,-36.49624565166414,-39.25698053333468,0.0282824241363357,43133872371.0,1
1985,2018-03-07,3288.86,3308.41,3264.76,3271.67,168665019.0,-17.9699999999998,17.9699999999998,0.0,46.594689638602354,3062.74,3335.99,76.46111619396167,-23.53888380603832,-34.51037543112216,-38.30765951289218,0.0009514893408719,42965207352.0,0
1986,2018-03-08,3268.35,3289.5,3261.55,3288.41,149827519.0,16.73999999999978,0.0,16.73999999999978,50.99508987097677,3113.61,3335.99,78.6041910243727,-21.395808975627308,-31.225828957123667,-36.89129340173848,-0.0001854655794127,43115034871.0,1
1987,2018-03-09,3291.43,3309.72,3283.56,3307.17,168424509.0,18.76000000000022,0.0,18.76000000000022,55.71358536489196,3171.38,3335.99,82.49195067128379,-17.50804932871622,-26.800092215875797,-34.873053164565945,-0.006727595455269,43283459380.0,1
1988,2018-03-12,3319.21,3333.56,3313.56,3326.7,206532436.0,19.529999999999745,0.0,19.529999999999745,60.304720991198586,3171.38,3335.99,94.35635745094469,-5.643642549055332,-21.46927178081341,-32.19229688781544,0.0105192173920967,43489991816.0,1
1989,2018-03-13,3324.12,3333.88,3307.38,3310.24,177114353.0,-16.460000000000036,16.460000000000036,0.0,54.78188591960072,3228.58,3335.99,76.02644074108554,-23.973559258914477,-18.361087431054784,-29.426054996463307,0.0155948469201481,43312877463.0,0
1990,2018-03-14,3298.67,3304.98,3287.36,3291.38,157491085.0,-18.859999999999676,18.859999999999676,0.0,48.86530097668915,3228.58,3335.99,58.46755423144984,-41.53244576855016,-17.221158525333976,-26.98507570223744,0.0053852615502101,43155386378.0,0
1991,2018-03-15,3277.51,3297.1,3273.2,3291.11,148573606.0,-0.2699999999999818,0.2699999999999818,0.0,48.77827867262695,3228.58,3335.99,58.21618098873502,-41.78381901126498,-16.153337775549517,-24.81872811689985,0.0112397181774326,43006812772.0,0
1992,2018-03-16,3290.21,3300.57,3269.28,3269.88,141203647.0,-21.230000000000015,21.230000000000015,0.0,41.99335845067015,3228.58,3333.88,39.22127255460599,-60.77872744539401,-16.826203709187666,-23.22022323535742,0.0039761370370257,42865609125.0,0
1993,2018-03-19,3264.93,3280.57,3251.05,3279.25,137954980.0,9.36999999999989,0.0,9.36999999999989,45.83052297988349,3228.58,3333.88,48.119658119658105,-51.880341880341895,-16.41416187703362,-21.85901096369266,-0.0031584003112802,43003564105.0,1
1994,2018-03-20,3257.22,3292.57,3252.43,3290.64,139881081.0,11.389999999999873,0.0,11.389999999999873,50.42975970747183,3228.58,3333.88,58.93637226970545,-41.06362773029455,-14.9956771153511,-20.48634419402435,0.0057982620496566,43143445186.0,1
1995,2018-03-21,3299.73,3314.21,3268.88,3280.95,168398277.0,-9.690000000000056,9.690000000000056,0.0,46.55004999110265,3236.72,3333.88,45.52284890901593,-54.47715109098407,-14.486429201037026,-19.28636119542689,-0.0022685735659483,42975046909.0,0
1996,2018-03-22,3281.26,3288.8,3242.76,3263.48,150432977.0,-17.4699999999998,17.4699999999998,0.0,40.12795919263159,3236.72,3333.88,27.54219843557033,-72.45780156442967,-15.315976513742951,-18.492284259090106,-0.0132106907113936,42824613932.0,0
1997,2018-03-23,3172.77,3188.24,3110.66,3152.76,275532013.0,-110.7199999999998,110.7199999999998,0.0,19.975338835926934,3110.66,3333.88,18.86031717588044,-81.13968282411956,-24.62373037396719,-19.718573482065523,-0.0522860492379835,42549081919.0,0
1998,2018-03-26,3117.32,3134.28,3091.46,3133.72,186366350.0,-19.04000000000042,19.04000000000042,0.0,18.165194231972507,3091.46,3333.88,17.43255506971362,-82.56744493028638,-33.15437820891384,-22.40573442743519,-0.0533254386388902,42362715569.0,0
1999,2018-03-27,3164.8,3172.78,3143.57,3166.65,189073383.0,32.93000000000029,0.0,32.93000000000029,30.69773772167341,3091.46,3333.88,31.01641778731129,-68.98358221268872,-36.833211946162464,-25.29122993118065,-0.0378959585341103,42551788952.0,1
2000,2018-03-28,3130.57,3165.21,3117.53,3122.29,163500488.0,-44.36000000000013,44.36000000000013,0.0,24.79544455583219,3091.46,3333.88,12.71759755795723,-87.28240244204277,-42.83442684633019,-28.79986931421056,-0.0512957634354367,42388288464.0,0
2001,2018-03-29,3127.26,3174.51,3098.25,3160.53,170312384.0,38.24000000000024,0.0,38.24000000000024,36.86891007076762,3091.46,3333.88,28.491873607788197,-71.5081263922118,-43.99760744507921,-31.83941694038429,-0.0334415941869425,42558600848.0,1
2002,2018-03-30,3161.79,3177.72,3152.89,3168.9,154646596.0,8.36999999999989,0.0,8.36999999999989,39.32885546393043,3091.46,3333.88,31.944559029783036,-68.05544097021696,-43.73984173247345,-34.21950189880213,-0.0336509872684303,42713247444.0,1
2003,2018-04-02,3169.78,3192.34,3159.99,3163.18,177727777.0,-5.720000000000255,5.720000000000255,0.0,38.1564741344628,3091.46,3314.21,32.19753086419745,-67.80246913580255,-43.4957251002902,-36.07474653909974,-0.0387341064352223,42535519667.0,0
2004,2018-04-03,3130.01,3144.33,3119.13,3136.63,152216674.0,-26.549999999999727,26.549999999999727,0.0,32.90338710492745,3091.46,3314.21,20.278338945005643,-79.72166105499436,-44.92673656965826,-37.84514454521145,-0.0439872597875614,42383302993.0,0
2005,2018-04-04,3147.05,3163.34,3128.87,3131.11,146976682.0,-5.519999999999982,5.519999999999982,0.0,31.851430651201312,3091.46,3314.21,17.800224466891173,-82.19977553310882,-45.97625568019384,-39.47136677220793,-0.0405609962371456,42236326311.0,0
2006,2018-04-09,3125.44,3146.09,3110.3,3138.29,139608621.0,7.179999999999836,0.0,7.179999999999836,34.97170510328796,3091.46,3314.21,21.023569023568992,-78.976430976431,-45.70181902115246,-40.71745722199684,-0.0045896294040778,42375934932.0,1
2007,2018-04-10,3144.26,3190.65,3139.08,3190.32,168201359.0,52.0300000000002,0.0,52.0300000000002,52.97470470700468,3091.46,3314.21,44.38159371492711,-55.61840628507289,-40.81544478377055,-40.73705473435158,0.0180616009088241,42544136291.0,1
2008,2018-04-11,3197.37,3220.85,3191.59,3208.08,175867197.0,17.759999999999764,0.0,17.759999999999764,57.5981368474635,3091.46,3314.21,52.354657687990965,-47.64534231200903,-35.10520348914088,-39.61068448530944,0.013083226753825,42720003488.0,1
2009,2018-04-12,3203.28,3205.25,3177.05,3180.16,148231313.0,-27.920000000000076,27.920000000000076,0.0,48.8806672524881,3091.46,3288.8,44.94780581737091,-55.05219418262909,-32.4585448852099,-38.18025656528954,0.018534473095068,42571772175.0,0
2010,2018-04-13,3192.04,3197.9,3155.51,3159.05,127552310.0,-21.109999999999676,21.109999999999676,0.0,43.17930797062553,3091.46,3220.85,52.23742174820328,-47.762578251796725,-31.6990426184816,-36.884013775927954,-0.000468275890436,42444219865.0,0
2011,2018-04-16,3152.89,3153.11,3096.1,3110.65,154415695.0,-48.40000000000009,48.40000000000009,0.0,32.99745602047446,3091.46,3220.85,14.831130690161585,-85.16886930983841,-34.60371699505004,-36.427954419752375,-0.0183817728549339,42289804170.0,0
2012,2018-04-17,3112.97,3118.76,3064.03,3066.8,147222846.0,-43.84999999999991,43.84999999999991,0.0,26.472010485304565,3064.03,3220.85,1.766356332100489,-98.2336436678995,-39.98312037275991,-37.13898761035389,-0.0304693378182713,42142581324.0,0
2013,2018-04-18,3091.91,3096.89,3041.62,3091.4,159290503.0,24.59999999999991,0.0,24.59999999999991,34.81617687140594,3041.62,3220.85,27.774368130335432,-72.22563186966457,-41.77971139093415,-38.06713236646994,-0.0144199347707572,42301871827.0,1
2014,2018-04-19,3094.27,3127.44,3090.29,3117.38,160056805.0,25.980000000000015,0.0,25.980000000000015,42.73517353046342,3041.62,3220.85,42.26970931205725,-57.73029068794276,-40.63869624687186,-38.58144514255033,-0.0043850263963898,42461928632.0,1
2015,2018-04-20,3105.46,3111.17,3065.92,3071.54,155147091.0,-45.84000000000015,45.84000000000015,0.0,34.261213033703925,3041.62,3220.85,16.693633878257028,-83.30636612174297,-42.93837160412341,-39.45283043486495,-0.0212695448795363,42306781541.0,0
2016,2018-04-23,3063.44,3085.06,3045.94,3068.01,131686340.0,-3.5299999999997453,3.5299999999997453,0.0,33.66801932776947,3041.62,3220.85,14.724097528315752,-85.27590247168425,-44.5323808258554,-40.46874051306304,-0.038337846987136,42175095201.0,0
2017,2018-04-24,3069.75,3136.04,3069.75,3128.93,162274806.0,60.91999999999962,0.0,60.91999999999962,50.674032393812126,3041.62,3220.85,48.71394297829601,-51.28605702170399,-40.414041830621045,-40.45780077657464,-0.0246720780030423,42337370007.0,1
2018,2018-04-25,3112.4,3122.91,3107.0,3117.97,127311053.0,-10.960000000000036,10.960000000000036,0.0,48.113417232042345,3041.62,3220.85,42.59889527422859,-57.40110472577141,-37.60116607275222,-39.886473835810165,-0.0195556198430267,42210058954.0,0
2019,2018-04-26,3119.5,3121.93,3067.93,3075.03,133972736.0,-42.9399999999996,42.9399999999996,0.0,39.1665069631755,3041.62,3220.85,18.64085253584796,-81.35914746415203,-38.394255822881405,-39.588030233224416,-0.0265966034092527,42076086218.0,0
2020,2018-04-27,3082.41,3088.03,3049.91,3082.23,131225643.0,7.199999999999818,0.0,7.199999999999818,41.27910986290767,3041.62,3220.85,22.658037158957832,-77.34196284104216,-38.00372208497174,-39.27116860357389,-0.0091363541382026,42207311861.0,1
2021,2018-05-02,3087.41,3097.6,3064.76,3081.18,134184566.0,-1.050000000000182,1.050000000000182,0.0,41.03929301122175,3041.62,3220.85,22.07219773475419,-77.9278022652458,-37.34841819247868,-38.88661852135485,0.00468892656841,42073127295.0,0
2022,2018-05-03,3074.52,3105.66,3056.16,3100.86,139985620.0,19.68000000000029,0.0,19.68000000000029,47.62035021458557,3041.62,3205.25,36.20363014117228,-63.79636985882773,-34.839465932634084,-38.0771880036107,0.0030601022190592,42213112915.0,1
2023,2018-05-04,3093.12,3104.09,3086.78,3091.03,118711265.0,-9.829999999999927,9.829999999999927,0.0,44.74211785712164,3041.62,3197.9,31.616329664704534,-68.38367033529546,-33.260891188509504,-37.11392864059047,-0.0084526108462875,42094401650.0,0
2024,2018-05-07,3094.9,3136.84,3091.66,3136.64,138948186.0,45.60999999999967,0.0,45.60999999999967,58.25133823240808,3041.62,3153.11,85.22737465243499,-14.772625347565002,-28.00667005065088,-35.29247692260255,0.0211945799175656,42233349836.0,1
2025,2018-05-08,3135.3,3169.7,3134.06,3161.5,146927061.0,24.860000000000127,0.0,24.860000000000127,63.81492079156335,3041.62,3169.7,93.59775140537178,-6.40224859462822,-21.58781679391677,-32.551544896865394,0.0304725212760061,42380276897.0,1
2026,2018-05-09,3160.14,3165.37,3145.66,3159.15,122637268.0,-2.349999999999909,2.349999999999909,0.0,62.90063566007652,3041.62,3169.7,91.76296064959422,-8.237039350405787,-16.500250090846748,-29.341285935661663,0.0096582537800462,42257639629.0,0
2027,2018-05-10,3169.05,3176.14,3155.53,3174.41,133000756.0,15.259999999999764,0.0,15.259999999999764,66.4971048106371,3045.94,3176.14,98.67127496159752,-1.3287250384024736,-11.108905806780513,-25.694809909885432,0.0181015211820512,42390640385.0,1
2028,2018-05-11,3179.8,3180.76,3162.21,3163.26,130659749.0,-11.149999999999636,11.149999999999636,0.0,61.47295905536528,3045.94,3180.76,87.01973001038424,-12.980269989615769,-7.647779592121424,-22.085403846332632,0.0286924030009463,42259980636.0,0
2029,2018-05-14,3167.04,3183.82,3163.48,3174.03,129327353.0,10.769999999999982,0.0,10.769999999999982,64.46523526806142,3045.94,3183.82,92.8996228604584,-7.100377139541599,-3.989771536850185,-18.466277384436143,0.0297836306829795,42389307989.0,1
2030,2018-05-15,3180.42,3192.81,3164.52,3192.12,124549051.0,18.08999999999969,0.0,18.08999999999969,69.11428745334392,3049.91,3192.81,99.517144856543,-0.4828551434570008,0.3647335951918649,-14.70007518851054,0.0360056861332347,42513857040.0,1
2031,2018-05-16,3180.23,3191.95,3166.81,3169.57,130524968.0,-22.549999999999727,22.549999999999727,0.0,58.168336308949726,3049.91,3192.81,83.73687893631927,-16.26312106368073,1.973366008100129,-11.365386949188409,0.0221583689686086,42383332072.0,0
2032,2018-05-17,3170.01,3172.77,3148.62,3154.28,113995567.0,-15.289999999999964,15.289999999999964,0.0,51.75548856283989,3049.91,3192.81,73.03708887333819,-26.962911126661805,1.9914869468962024,-8.694012169971485,0.0204624348518132,42269336505.0,0
2033,2018-05-18,3151.08,3193.45,3144.78,3193.3,136516918.0,39.01999999999998,0.0,39.01999999999998,63.578945801518685,3049.91,3193.45,99.89549951233133,-0.104500487668689,5.095695808381606,-5.9360705743008655,0.0180639155274435,42405853423.0,1
2034,2018-05-21,3206.18,3219.74,3203.34,3213.84,164459413.0,20.539999999999964,0.0,20.539999999999964,68.29789926819598,3056.16,3219.74,96.3932021029468,-3.606797897053208,9.108216189220911,-2.9272132215965097,0.0165554325478411,42570312836.0,1
2035,2018-05-22,3211.25,3214.59,3192.23,3214.35,144292684.0,0.5099999999997635,0.0,0.5099999999997635,68.41514302900487,3056.16,3219.74,96.70497615845466,-3.295023841545345,12.18881516350666,0.0959924554241251,0.0174730544608516,42714605520.0,1
2036,2018-05-23,3205.44,3205.44,3168.96,3168.96,157807648.0,-45.38999999999987,45.38999999999987,0.0,49.58385891548743,3086.78,3219.74,61.80806257521066,-38.19193742478934,10.84263128109751,2.2453202205588028,-0.0017168544705944,42556797872.0,0
2037,2018-05-24,3167.94,3173.53,3152.07,3154.65,124085800.0,-14.309999999999944,14.309999999999944,0.0,45.07099535498034,3091.66,3219.74,49.18019987507829,-50.81980012492171,8.522827597944342,3.5008216960359118,-0.0027218755334686,42432712072.0,0
2038,2018-05-25,3148.41,3156.73,3131.07,3141.3,128610843.0,-13.349999999999907,13.349999999999907,0.0,41.049316824721146,3131.07,3219.74,11.53716025713326,-88.46283974286673,5.543234084385858,3.909304173705901,-0.01031181179762,42304101229.0,0
2039,2018-05-28,3136.81,3149.66,3115.96,3135.08,128755918.0,-6.220000000000255,6.220000000000255,0.0,39.17032700810453,3115.96,3219.74,18.423588359992237,-81.57641164000778,2.649441626932912,3.657331664351304,-0.0178690024184554,42175345311.0,0
2040,2018-05-29,3129.62,3143.21,3112.15,3120.46,135717800.0,-14.61999999999989,14.61999999999989,0.0,34.844602102532875,3112.15,3219.74,7.72376614927035,-92.27623385072964,-0.8142355591280648,2.76301821965543,-0.0154942153036532,42039627511.0,0
2041,2018-05-30,3081.14,3085.4,3041.0,3041.44,155115126.0,-79.01999999999998,79.01999999999998,0.0,20.63380223992327,3041.0,3219.74,0.246167617768857,-99.75383238223114,-9.8222534620636,0.2459638833116234,-0.0357736155319122,41884512385.0,0
2042,2018-05-31,3061.83,3098.08,3054.27,3095.47,140475532.0,54.02999999999975,0.0,54.02999999999975,39.954046341739314,3041.0,3219.74,30.474432136063484,-69.52556786393652,-12.457797363655573,-2.2947883660818165,-0.0306360191651271,42024987917.0,1
2043,2018-06-01,3084.75,3102.09,3059.79,3075.14,129872199.0,-20.329999999999927,20.329999999999927,0.0,36.134996158667946,3041.0,3219.74,19.100369251426606,-80.89963074857339,-16.002479367881733,-5.036326566441801,-0.0431570955616957,41895115718.0,0
2044,2018-06-04,3083.43,3098.4,3076.99,3091.19,114593902.0,16.050000000000182,0.0,16.050000000000182,41.25045579880886,3041.0,3219.74,28.07989258140322,-71.92010741859679,-17.31694556073262,-7.492450365299966,-0.0383156781308817,42009709620.0,1
2045,2018-06-05,3088.01,3114.77,3080.05,3114.21,118735592.0,23.019999999999985,0.0,23.019999999999985,48.12659507635068,3041.0,3219.74,40.95893476558136,-59.041065234418646,-16.313100605721502,-9.256580413384274,-0.01727696152681,42128445212.0,1
2046,2018-06-06,3109.17,3117.53,3103.53,3115.18,120196135.0,0.9699999999998,0.0,0.9699999999998,48.42011316451174,3041.0,3219.74,41.5016224683898,-58.4983775316102,-15.263329195319784,-10.457930169771377,-0.0125116890938773,42248641347.0,1
2047,2018-06-07,3121.18,3128.72,3105.58,3109.5,127784970.0,-5.679999999999836,5.679999999999836,0.0,46.63713317676,3041.0,3219.74,38.32382231173776,-61.67617768826224,-14.720023056739135,-11.31034874716493,-0.0101231974023493,42120856377.0,0
2048,2018-06-08,3100.6,3100.68,3053.29,3067.15,134688220.0,-42.34999999999991,42.34999999999991,0.0,35.4172469338084,3041.0,3214.59,15.064231810588208,-84.9357681894118,-17.504953881990787,-12.549269774130105,-0.0216677086390139,41986168157.0,0
2049,2018-06-11,3057.34,3063.61,3037.91,3052.78,108563786.0,-14.36999999999989,14.36999999999989,0.0,32.36844183911802,3037.91,3205.44,8.876022204978408,-91.1239777950216,-20.63371787462984,-14.166159394230052,-0.0216891099389192,41877604371.0,0
2050,2018-06-12,3053.03,3081.45,3034.1,3079.8,113275096.0,27.019999999999985,0.0,27.019999999999985,43.011750609480586,3034.1,3173.53,32.77630352148044,-67.22369647851956,-20.694445015590645,-15.471816518502171,0.0126124467357569,41990879467.0,1
2051,2018-06-13,3071.46,3071.46,3044.12,3049.8,119607886.0,-30.0,30.0,0.0,35.7951140298635,3034.1,3156.73,12.80273994944162,-87.19726005055838,-22.899351521863537,-16.957323519174444,-0.0147538176755063,41871271581.0,0
2052,2018-06-14,3038.07,3066.05,3032.41,3044.16,115469487.0,-5.640000000000327,5.640000000000327,0.0,34.53806707328552,3032.41,3149.66,10.021321961620467,-89.97867803837953,-24.81579563336618,-18.529017942012796,-0.0100743380789167,41755802094.0,0
2053,2018-06-15,3037.45,3048.8,3008.73,3021.9,144532571.0,-22.259999999999764,22.259999999999764,0.0,29.776070321068588,3008.73,3143.21,9.79327781082694,-90.20672218917306,-27.81020859100136,-20.385256071810502,-0.022415315784536,41611269523.0,0
2054,2018-06-19,2982.65,2984.97,2871.35,2907.82,230550067.0,-114.07999999999991,114.07999999999991,0.0,16.402737375943218,2871.35,3128.72,14.170260714147052,-85.82973928585295,-38.93973203540463,-24.096151264529333,-0.0662736295882422,41380719456.0,0
2055,2018-06-20,2889.98,2925.56,2872.16,2915.73,144301420.0,7.9099999999998545,0.0,7.9099999999998545,19.302401942422264,2871.35,3128.72,17.243656991879444,-82.75634300812055,-46.58468935469091,-28.59385888256165,-0.064025192765747,41525020876.0,1
2056,2018-06-21,2912.0,2940.59,2872.62,2875.81,154378332.0,-39.92000000000007,39.92000000000007,0.0,16.058780127767818,2871.35,3128.72,1.7329137040059208,-98.26708629599408,-55.22795005379294,-33.92067711680791,-0.0751535616658627,41370642544.0,0
2057,2018-06-22,2855.58,2891.97,2837.14,2889.76,126143129.0,13.950000000000273,0.0,13.950000000000273,21.385422323884683,2837.14,3128.72,18.0465052472736,-81.9534947527264,-60.25753664079548,-39.18804902160542,-0.0578354498475783,41496785673.0,1
2058,2018-06-25,2903.45,2908.62,2857.87,2859.34,121917687.0,-30.420000000000076,30.420000000000076,0.0,18.44102616953548,2837.14,3128.72,7.613690925303613,-92.38630907469638,-65.93806702501888,-44.53805262228812,-0.0633651950025878,41374867986.0,0
2059,2018-06-26,2829.99,2850.24,2803.79,2844.51,125918468.0,-14.829999999999927,14.829999999999927,0.0,17.11547296628646,2803.79,3128.72,12.531929954144056,-87.46807004585595,-70.82021399812857,-49.794484897456215,-0.0763978180401324,41248949518.0,0
2060,2018-06-27,2842.4,2854.26,2798.8,2813.18,129420833.0,-31.330000000000386,31.330000000000386,0.0,14.563655392298443,2798.8,3128.72,4.358632395732199,-95.6413676042678,-76.33744921639845,-55.10307776124467,-0.0775854154370779,41119528685.0,0
2061,2018-06-28,2799.9,2825.99,2782.45,2786.9,118357907.0,-26.279999999999745,26.279999999999745,0.0,12.727103633534853,2782.45,3100.68,1.3983596769632884,-98.6016403230367,-81.88653721685068,-60.45976965236588,-0.084509355618627,41001170778.0,0
2062,2018-06-29,2789.81,2848.37,2782.38,2847.42,125671685.0,60.51999999999998,0.0,60.51999999999998,34.631177886621145,2782.38,3081.45,21.74741699267731,-78.2525830073227,-80.47312710647066,-64.46244114318684,-0.0577385088851385,41126842463.0,1
2063,2018-07-02,2841.58,2845.68,2756.81,2775.56,137035034.0,-71.86000000000013,71.86000000000013,0.0,25.769928982443982,2756.81,3081.45,5.7756283883686566,-94.22437161163134,-84.18110349171184,-68.40617361289183,-0.0454842459299407,40989807429.0,0
2064,2018-07-03,2774.57,2786.89,2722.45,2786.89,142498466.0,11.329999999999927,0.0,11.329999999999927,29.0716337202567,2722.45,3071.46,18.463654336551965,-81.53634566344805,-85.22306671671049,-71.76955223365557,-0.04418790491575,41132305895.0,1
2065,2018-07-04,2776.63,2793.18,2754.16,2759.13,123262181.0,-27.759999999999764,27.759999999999764,0.0,25.824316926974447,2722.45,3066.05,10.675203725262003,-89.32479627473799,-87.28268956573584,-74.87217970007163,-0.0405729168477749,41009043714.0,0
2066,2018-07-05,2755.34,2777.52,2727.94,2733.88,129226112.0,-25.25,25.25,0.0,23.114558082807847,2722.45,3048.8,3.5023747510342518,-96.49762524896576,-89.91592468031968,-77.88092869612125,-0.0539421958917003,40879817602.0,0
2067,2018-07-06,2731.35,2768.87,2691.02,2747.23,136294380.0,13.349999999999907,0.0,13.349999999999907,27.740143290924397,2691.02,2984.97,19.1222997108352,-80.8777002891648,-89.88936045749733,-80.28261504839647,-0.0392083487797884,41016111982.0,1
2068,2018-07-09,2752.45,2815.79,2752.45,2815.11,121549309.0,67.88000000000011,0.0,67.88000000000011,46.59146197524042,2691.02,2940.59,49.72152101614781,-50.2784789838522,-83.42923908112652,-80.91193985494249,-0.0103356992944303,41137661291.0,1
2069,2018-07-10,2819.71,2828.49,2800.62,2827.63,117062748.0,12.519999999999982,0.0,12.519999999999982,49.400767484036585,2691.02,2940.59,54.73814961734185,-45.26185038265816,-76.41838342634946,-80.01322856922388,0.0051365358775479,41254724039.0,1
2070,2018-07-11,2780.7,2794.36,2752.44,2777.77,126821149.0,-49.86000000000013,49.86000000000013,0.0,39.78465153407876,2691.02,2908.62,39.866727941176485,-60.13327205882352,-74.03211892843228,-78.81700664106557,-0.0032760414797804,41127902890.0,0
2071,2018-07-12,2771.04,2844.19,2771.04,2837.66,146980200.0,59.88999999999987,0.0,59.88999999999987,52.5782685954084,2691.02,2908.62,67.38970588235291,-32.610294117647086,-66.54131775281758,-76.36186886341598,-0.0034276643417551,41274883090.0,1
2072,2018-07-13,2831.43,2835.46,2818.85,2831.18,117689348.0,-6.480000000000018,6.480000000000018,0.0,51.21966891009914,2691.02,2854.26,85.86130850281772,-14.138691497182275,-60.4310738943982,-73.17570986961242,0.0200391992967183,41157193742.0,0
2073,2018-07-16,2827.08,2837.51,2804.49,2814.04,107767151.0,-17.139999999999873,17.139999999999873,0.0,47.47563535015436,2691.02,2854.26,75.36143102180826,-24.638568978191746,-56.32246604071452,-69.80506110383284,0.0097420422047516,41049426591.0,0
2074,2018-07-17,2806.89,2806.92,2774.76,2798.13,105409220.0,-15.909999999999854,15.909999999999854,0.0,44.0286046087036,2691.02,2848.37,68.07117890054032,-31.92882109945968,-53.73079360787642,-66.59020760464156,0.0141348903458697,40944017371.0,0
2075,2018-07-18,2801.78,2818.4,2786.04,2787.26,120961165.0,-10.86999999999989,10.86999999999989,0.0,41.64494656905243,2691.02,2848.37,61.16301239275519,-38.83698760724481,-51.95508678889655,-63.66318344149256,0.0195253632200389,40823056206.0,0
2076,2018-07-19,2791.02,2805.01,2764.49,2772.55,114486493.0,-14.710000000000036,14.710000000000036,0.0,38.3988717258576,2691.02,2845.68,52.71563429458184,-47.28436570541816,-51.145230029993854,-61.15959275919283,0.0092165563130863,40708569713.0,0
2077,2018-07-20,2769.75,2837.86,2753.84,2829.27,145907688.0,56.7199999999998,0.0,56.7199999999998,54.26080701061021,2691.02,2844.19,90.2591891362538,-9.740810863746209,-45.40320288236353,-58.00831478382697,0.0050299988277544,40854477401.0,1
2078,2018-07-23,2815.2,2863.57,2809.62,2859.54,173382797.0,30.269999999999985,0.0,30.269999999999985,60.52062718192789,2691.02,2863.57,97.66444508838006,-2.335554911619934,-37.97234739197074,-54.001121305455726,0.0112850691214902,41027860198.0,1
2079,2018-07-24,2862.27,2911.46,2862.27,2905.56,229578307.0,46.01999999999998,0.0,46.01999999999998,68.16384263958021,2691.02,2911.46,97.3235347486844,-2.6764652513155918,-28.04660765001654,-48.81021857436789,0.0460045288126806,41257438505.0,1
2080,2018-07-25,2911.45,2912.31,2894.04,2903.65,167800207.0,-1.9099999999998545,1.9099999999998545,0.0,67.53768070905451,2691.02,2912.31,96.08658321659368,-3.913416783406325,-20.10277614107736,-43.06873008770979,0.0232550763657379,41089638298.0,0
2081,2018-07-26,2905.79,2915.3,2875.7,2882.23,168428202.0,-21.420000000000076,21.420000000000076,0.0,60.36248559352698,2752.44,2915.3,79.6942158909492,-20.305784109050805,-15.358603008535283,-37.52670467187489,0.0180313508854965,40921210096.0,0
2082,2018-07-27,2879.69,2889.69,2864.11,2873.59,146371610.0,-8.639999999999873,8.639999999999873,0.0,57.51843812894275,2752.44,2915.3,74.38904580621393,-25.61095419378608,-12.155862200889716,-32.45253617767786,0.0211617461016901,40774838486.0,0
2083,2018-07-30,2871.94,2896.01,2850.3,2869.05,151652249.0,-4.539999999999964,4.539999999999964,0.0,55.920962003032464,2752.44,2915.3,71.60137541446645,-28.398624585533565,-9.87022923534596,-27.936074789211474,0.0253454986008512,40623186237.0,0
2084,2018-07-31,2866.9,2884.68,2854.32,2876.4,118931117.0,7.349999999999909,0.0,7.349999999999909,58.09502569659973,2753.84,2915.3,75.90734547256281,-24.092654527437187,-7.380685125756372,-23.824996856520453,0.031981228877105,40742117354.0,1
2085,2018-08-01,2882.51,2897.4,2823.93,2824.53,149514348.0,-51.86999999999989,51.86999999999989,0.0,41.44844026872831,2753.84,2915.3,43.781741607828586,-56.21825839217141,-9.483855009972558,-20.95676848721088,0.0187480838938882,40592603006.0,0
2086,2018-08-02,2815.34,2815.34,2726.48,2768.02,174179003.0,-56.51000000000022,56.51000000000022,0.0,30.472322879473,2726.48,2915.3,21.999788158034068,-78.00021184196592,-15.531479790940011,-19.871710747956705,-0.0216486938326847,40418424003.0,0
2087,2018-08-03,2763.4,2777.66,2740.43,2740.44,127006363.0,-27.579999999999927,27.579999999999927,0.0,26.517793579507146,2726.48,2915.3,7.39328460968119,-92.6067153903188,-22.29276439379601,-20.355921477124568,-0.0416500556033487,40291417640.0,0
2088,2018-08-06,2736.53,2760.47,2692.32,2705.16,129753058.0,-35.2800000000002,35.2800000000002,0.0,22.254960844220108,2692.32,2915.3,5.758363978832043,-94.24163602116796,-30.150377522599683,-22.314812686219597,-0.0689712138107628,40161664582.0,0
2089,2018-08-07,2711.74,2779.37,2696.04,2779.37,149579743.0,74.21000000000004,0.0,74.21000000000004,44.07475191149755,2692.32,2915.3,39.03937572876479,-60.96062427123521,-30.043147039210908,-23.860479556817857,-0.0428013018097912,40311244325.0,1
2090,2018-08-08,2771.13,2779.91,2741.07,2744.07,147688715.0,-35.29999999999973,35.29999999999973,0.0,38.19164845398908,2692.32,2915.3,23.20835949412503,-76.79164050587497,-32.43271692214921,-25.574927029884133,-0.0479351058034923,40163555610.0,0
2091,2018-08-09,2729.58,2801.66,2726.22,2794.38,151660333.0,50.309999999999945,0.0,50.309999999999945,49.31684662569598,2692.32,2915.3,45.770921158848296,-54.2290788411517,-29.92195011337253,-26.44433164658181,-0.0275648230958487,40315215943.0,1
2092,2018-08-10,2791.4,2806.11,2777.51,2795.31,121532232.0,0.9299999999998364,0.0,0.9299999999998364,49.51068360059275,2692.32,2915.3,46.18799892367018,-53.81200107632982,-27.539646202069434,-26.663394557679336,-0.0257018873843258,40436748175.0,1
2093,2018-08-13,2769.02,2789.8,2742.56,2785.87,127532241.0,-9.440000000000056,9.440000000000056,0.0,47.388032450441855,2692.32,2915.3,41.95443537536986,-58.04556462463014,-26.11237508977229,-26.55319066409793,-0.0314733694896398,40309215934.0,0
2094,2018-08-14,2780.74,2789.44,2766.57,2780.96,109571077.0,-4.909999999999855,4.909999999999855,0.0,46.19933099665441,2692.32,2915.3,39.75244416539594,-60.24755583460406,-25.088246724413693,-26.260201876161084,-0.0154255752284451,40199644857.0,0
2095,2018-08-15,2777.25,2777.7,2721.24,2723.26,116161787.0,-57.69999999999982,57.69999999999982,0.0,34.47373990044545,2692.32,2897.4,15.086795396918308,-84.9132046030817,-28.602810008256256,-26.72872350258012,-0.0161704033930389,40083483070.0,0
2096,2018-08-16,2691.43,2732.95,2672.74,2705.19,120277878.0,-18.070000000000164,18.070000000000164,0.0,31.57766788353584,2672.74,2897.4,14.444048784830512,-85.55595121516949,-32.47190876330933,-27.877360554725964,-0.0128628979287997,39963205192.0,0
2097,2018-08-17,2723.89,2730.33,2665.59,2668.97,112445294.0,-36.220000000000255,36.220000000000255,0.0,26.440449867106835,2665.59,2897.4,1.4580906777100449,-98.54190932228995,-38.02254842879711,-29.9063981295402,-0.0133781365982049,39850759898.0,0
2098,2018-08-20,2673.07,2698.47,2653.11,2698.47,110784164.0,29.5,0.0,29.5,36.195329037547246,2653.11,2897.4,18.568095296573613,-81.43190470342638,-39.58475844103077,-31.842070191838317,-0.0291073156866484,39961544062.0,1
2099,2018-08-21,2700.34,2739.17,2696.29,2733.83,113586839.0,35.36000000000013,0.0,35.36000000000013,46.08401376080216,2653.11,2815.34,49.75651852308438,-50.24348147691562,-37.53686305527617,-32.98102876452589,-0.0037316832296553,40075130901.0,1
2100,2018-08-22,2731.96,2731.96,2709.06,2714.61,93664640.0,-19.2199999999998,19.2199999999998,0.0,42.00139517954271,2653.11,2806.11,40.19607843137255,-59.80392156862745,-37.03783546751674,-33.792390105124056,-0.0285465827840164,39981466261.0,0
2101,2018-08-23,2714.87,2736.01,2700.8,2724.62,98446470.0,10.009999999999764,0.0,10.009999999999764,44.933019875422055,2653.11,2806.11,46.73856209150311,-53.26143790849689,-35.426257323631035,-34.119163548825455,-0.0252887872901396,40079912731.0,1
2102,2018-08-24,2717.08,2748.82,2705.32,2729.43,100516269.0,4.809999999999945,0.0,4.809999999999945,46.43421519883684,2653.11,2806.11,49.88235294117628,-50.11764705882372,-33.376203138836445,-33.97057146682765,-0.0202593803730971,40180429000.0,1
2103,2018-08-27,2736.32,2780.9,2736.32,2780.9,132762578.0,51.470000000000255,0.0,51.470000000000255,59.92358838126999,2653.11,2806.11,83.52287581699343,-16.47712418300656,-27.28381079304154,-32.633219332070425,-2.1575283355335092e-05,40313191578.0,1
2104,2018-08-28,2782.29,2791.39,2769.4,2777.98,118749367.0,-2.9200000000000728,2.9200000000000728,0.0,58.95178623032137,2653.11,2806.11,81.61437908496725,-18.385620915032757,-22.43257678088821,-30.593090821833982,0.0200935643309856,40194442211.0,0
2105,2018-08-29,2774.86,2778.54,2762.35,2769.29,100156929.0,-8.690000000000055,8.690000000000055,0.0,55.84203185448061,2653.11,2806.11,75.93464052287571,-24.06535947712429,-19.06932988497465,-28.288338634462114,0.0236951933135933,40094285282.0,0
2106,2018-08-30,2769.33,2780.53,2736.35,2737.74,106060943.0,-31.550000000000185,31.550000000000185,0.0,45.73534952566026,2653.11,2791.39,61.201909169800274,-38.79809083019973,-18.73380220430181,-26.377431348430058,0.0257664941906428,39988224339.0,0
2107,2018-08-31,2730.11,2744.63,2710.54,2725.25,109758742.0,-12.489999999999782,12.489999999999782,0.0,42.2430339046288,2653.11,2791.39,52.16951113682384,-47.83048886317616,-19.25378704475133,-24.95270248769432,0.009924142199098,39878465597.0,0
2108,2018-09-03,2716.4,2722.85,2692.36,2720.73,102213011.0,-4.519999999999982,4.519999999999982,0.0,40.93773726001493,2653.11,2791.39,48.90078102400926,-51.09921897599074,-19.80233599900976,-23.92262918995741,-0.0047918122194868,39776252586.0,0
2109,2018-09-04,2720.65,2756.61,2712.38,2750.58,109010307.0,29.84999999999991,0.0,29.84999999999991,52.19391844868868,2653.11,2791.39,70.4874168354064,-29.512583164593597,-17.6252465928128,-22.66315267052849,0.0132505221744558,39885262893.0,1
2110,2018-09-05,2741.38,2745.47,2704.34,2704.34,105002269.0,-46.23999999999978,46.23999999999978,0.0,38.93193730644545,2653.11,2791.39,37.048018513161786,-62.95198148683821,-19.40735322222781,-22.01199278086836,-0.0074432397912368,39780260624.0,0
2111,2018-09-06,2697.58,2719.41,2683.74,2691.59,99017833.0,-12.75,12.75,0.0,36.0200591960387,2653.11,2791.39,27.827596181660464,-72.17240381833953,-21.59951820855258,-21.929497866405203,-0.0138637004795871,39681242791.0,0
2112,2018-09-07,2696.68,2728.55,2683.72,2702.3,107523293.0,10.710000000000036,0.0,10.710000000000036,40.34463836410168,2683.72,2791.39,17.25643168942172,-82.74356831057827,-22.21651905871022,-21.986902104866207,-0.028264231004351,39788766084.0,1
2113,2018-09-10,2698.01,2703.43,2667.32,2669.48,103559170.0,-32.820000000000164,32.820000000000164,0.0,32.56227115371685,2667.32,2791.39,1.740952687998597,-98.2590473120014,-25.06486423694014,-22.602494531281,-0.0390571566389966,39685206914.0,0
2114,2018-09-11,2668.49,2680.57,2652.7,2664.8,99865946.0,-4.679999999999836,4.679999999999836,0.0,31.560597408638785,2652.7,2791.39,8.724493474655965,-91.27550652534404,-27.384167561912363,-23.558829137407272,-0.0377316929610116,39585340968.0,0
2115,2018-09-12,2659.74,2672.07,2647.17,2656.11,90026758.0,-8.690000000000055,8.690000000000055,0.0,29.609139373280343,2647.17,2791.39,6.198862848426062,-93.80113715157393,-29.58243463917688,-24.7635502377612,-0.0298165640272632,39495314210.0,0
2116,2018-09-13,2679.21,2689.06,2653.19,2686.58,107335014.0,30.4699999999998,0.0,30.4699999999998,43.69443344230967,2647.17,2791.39,27.326307030924912,-72.67369296907509,-28.53694662690032,-25.518229515589024,-0.0141895238968902,39602649224.0,1
2117,2018-09-14,2688.78,2694.92,2675.29,2681.64,100005008.0,-4.940000000000055,4.940000000000055,0.0,42.11784553068513,2647.17,2791.39,23.90098460685054,-76.09901539314946,-27.78669879247309,-25.97192337096584,-0.0143674675546636,39502644216.0,0
2118,2018-09-17,2671.29,2671.29,2647.92,2651.79,88238888.0,-29.84999999999991,29.84999999999991,0.0,33.65203249967438,2647.17,2780.53,3.4643071385722006,-96.5356928614278,-29.263436827695383,-26.630226062311745,-0.0359160613397901,39414405328.0,0
2119,2018-09-18,2644.3,2700.19,2644.3,2699.95,115767993.0,48.159999999999854,0.0,48.159999999999854,51.71850257044358,2644.3,2780.53,40.85003303237145,-59.14996696762855,-26.24511549543104,-26.553203948935604,-0.0016233165948069,39530173321.0,1
2120,2018-09-19,2694.8,2746.08,2690.99,2730.85,141550318.0,30.90000000000009,0.0,30.90000000000009,59.81860639939927,2644.3,2756.61,77.06348499688343,-22.936515003116583,-21.116286924620454,-25.465820544072574,0.0145861739715185,39671723639.0,1
2121,2018-09-20,2732.17,2743.96,2724.08,2729.24,111387463.0,-1.610000000000127,1.610000000000127,0.0,59.22129192969624,2644.3,2756.61,75.62995280918852,-24.370047190811466,-16.98576554379042,-23.769809544016148,0.009969285423528,39560336176.0,0
2122,2018-09-21,2733.87,2797.49,2722.03,2797.48,158016642.0,68.24000000000024,0.0,68.24000000000024,72.60132846427021,2644.3,2797.49,99.99347215875726,-0.0065278412427466,-8.112385367427578,-20.638324708698438,0.0479494133688958,39718352818.0,1
2123,2018-09-25,2775.07,2790.03,2771.16,2781.14,111983179.0,-16.340000000000146,16.340000000000146,0.0,66.56681124449159,2644.3,2797.49,89.32697956785695,-10.673020432143058,-2.371333829052673,-16.984926532769283,0.0436580606424497,39606369639.0,0
2124,2018-09-26,2785.32,2827.34,2783.34,2806.81,139567706.0,25.670000000000076,0.0,25.670000000000076,70.9445276740442,2644.3,2827.34,88.78387237762226,-11.216127622377734,4.201414058039518,-12.74765841460752,0.0567371080263994,39745937345.0,1
2125,2018-09-27,2805.79,2810.51,2786.32,2791.77,123997696.0,-15.039999999999964,15.039999999999964,0.0,65.1752382332289,2644.3,2827.34,80.56708916083906,-19.43291083916093,8.103351416210899,-8.577456448443838,0.0391538684870726,39621939649.0,0
2126,2018-09-28,2794.26,2821.76,2791.84,2821.35,134290456.0,29.579999999999927,0.0,29.579999999999927,70.60072055281009,2644.3,2827.34,96.72749125874113,-3.272508741258872,13.427737079550296,-4.176417742845009,0.0520987157112811,39756230105.0,1
2127,2018-10-08,2768.21,2771.94,2710.18,2716.51,149501388.0,-104.83999999999968,104.83999999999968,0.0,43.12473083422447,2644.3,2827.34,39.45039335664338,-60.54960664335661,9.08293682057638,-1.5245468301607308,0.024406155841903,39606728717.0,0
2128,2018-10-09,2713.73,2734.31,2711.2,2721.01,116771899.0,4.5,0.0,4.5,44.20022988075741,2644.3,2827.34,41.90887237762241,-58.09112762237759,5.934356141088301,-0.032766235910924,0.0078001444471196,39723500616.0,1
2129,2018-10-10,2723.72,2743.55,2703.06,2725.84,113485736.0,4.829999999999927,0.0,4.829999999999927,45.47710376868602,2644.3,2827.34,44.547639860139846,-55.45236013986015,3.785190581477309,0.7308251275667229,-0.0018345936246955,39836986352.0,1
2130,2018-10-11,2643.07,2661.29,2560.32,2583.46,197150702.0,-142.3800000000001,142.3800000000001,0.0,25.57288629342325,2560.32,2827.34,8.666017526776972,-91.33398247322305,-9.29971338210953,-1.2752825743685283,-0.0534141372689832,39639835650.0,0
2131,2018-10-12,2574.04,2615.92,2536.67,2606.91,170081635.0,23.449999999999815,0.0,23.449999999999815,31.288021735000427,2536.67,2827.34,24.16486049471901,-75.83513950528098,-17.57478385634795,-4.5351828307644135,-0.0681220241074109,39809917285.0,1
2132,2018-10-15,2605.91,2611.97,2564.74,2568.1,118576197.0,-38.809999999999945,38.809999999999945,0.0,27.286767533427067,2536.67,2827.34,10.812949392782134,-89.18705060721787,-26.953773158315016,-9.018900896274536,-0.0766016813249242,39691341088.0,0
2133,2018-10-16,2567.76,2597.72,2536.44,2546.33,119419144.0,-21.769999999999985,21.769999999999985,0.0,25.200855383668014,2536.44,2827.34,3.399793743554441,-96.60020625644556,-35.73145682044469,-14.361412081108568,-0.0928028616115804,39571921944.0,0
2134,2018-10-17,2574.31,2582.55,2517.57,2561.61,129953997.0,15.2800000000002,0.0,15.2800000000002,29.56165279912433,2517.57,2827.34,14.216999709461849,-85.78300029053814,-40.98244593669551,-19.68561885222596,-0.0824423215379489,39701875941.0,1
2135,2018-10-18,2544.91,2544.91,2485.62,2486.42,125428513.0,-75.19000000000005,75.19000000000005,0.0,22.20977758558182,2485.62,2827.34,0.2341097974950782,-99.76589020250492,-50.62749500570408,-25.873994082921584,-0.118712673011147,39576447428.0,0
2136,2018-10-19,2460.08,2553.39,2449.2,2550.47,147323558.0,64.04999999999973,0.0,64.04999999999973,37.48989240015167,2449.2,2827.34,26.78108637012744,-73.21891362987256,-52.49780416226986,-31.198756098791243,-0.0611225432632313,39723770986.0,1
2137,2018-10-22,2565.64,2675.41,2565.64,2654.88,211888449.0,104.41000000000032,0.0,104.41000000000032,54.35433556128411,2449.2,2827.34,54.39255302269004,-45.60744697730996,-45.03587767055069,-33.966180413143135,-0.0243034755476827,39935659435.0,1
2138,2018-10-23,2652.65,2659.81,2583.26,2594.83,178343543.0,-60.05000000000018,60.05000000000018,0.0,46.100654651470144,2449.2,2821.76,39.08900579772384,-60.91099420227616,-43.46672298136264,-35.86628892678704,-0.0480622487013178,39757315892.0,0
2139,2018-10-24,2579.97,2640.4,2577.77,2603.3,160060407.0,8.470000000000255,0.0,8.470000000000255,47.4005634432314,2449.2,2821.76,41.36246510629166,-58.63753489370834,-41.06631149574423,-36.90629344057847,0.0076796234507212,39917376299.0,1
2140,2018-10-25,2540.93,2606.1,2531.53,2603.8,162032979.0,0.5,0.0,0.5,47.48682795010159,2449.2,2771.94,47.9023362458946,-52.0976637541054,-38.67776903270124,-37.26058855900303,-0.0011929832637105,40079409278.0,1
2141,2018-10-26,2610.9,2626.12,2580.85,2598.85,158936119.0,-4.950000000000273,4.950000000000273,0.0,46.61356216252354,2449.2,2743.55,50.84083573976555,-49.15916426023445,-36.76050335330592,-37.16057151786361,0.011973832794673,39920473159.0,0
2142,2018-10-29,2593.59,2595.54,2529.19,2542.1,134241923.0,-56.75,56.75,0.0,37.492823590808975,2449.2,2743.55,31.56106675726176,-68.43893324273824,-39.36651453493914,-37.60176012127872,-0.0016612143751988,39786231236.0,0
2143,2018-10-30,2538.57,2586.92,2521.78,2568.05,166682309.0,25.950000000000276,0.0,25.950000000000276,43.34204441917053,2449.2,2675.41,52.5396755227445,-47.4603244772555,-38.88955446886894,-37.85931899079676,0.0025140439020772,39952913545.0,1
2144,2018-10-31,2573.01,2612.92,2567.03,2602.78,180550348.0,34.73000000000002,0.0,34.73000000000002,50.495676417886735,2449.2,2675.41,67.89266610671515,-32.107333893284846,-35.30219767102017,-37.34789472684144,0.0467982078651234,40133463893.0,1
2145,2018-11-01,2617.03,2636.8,2603.65,2606.24,200903932.0,3.4599999999995816,0.0,3.4599999999995816,51.2038994323413,2449.2,2675.41,69.42221829273682,-30.577781707263192,-31.8132748502444,-36.24097075152204,0.0218665579285386,40334367825.0,1
2146,2018-11-02,2649.25,2676.48,2628.87,2676.48,225026921.0,70.24000000000024,0.0,70.24000000000024,63.45153715484178,2449.2,2676.48,100.0,-0.0,-23.114052983821693,-33.61558719798197,0.0081359609473874,40559394746.0,1
2147,2018-11-05,2665.43,2673.19,2639.27,2665.43,193760100.0,-11.050000000000182,11.050000000000182,0.0,60.68659733335853,2449.2,2676.48,95.1381555790214,-4.8618444209786045,-16.916496786666357,-30.275769115718845,0.0272079481122076,40365634646.0,0
2148,2018-11-06,2660.72,2660.86,2635.32,2659.36,163669479.0,-6.069999999999709,6.069999999999709,0.0,59.05550610815956,2449.2,2676.48,92.46744104188672,-7.532558958113286,-12.352297523520065,-26.69107479727909,0.0215342065839512,40201965167.0,0
2149,2018-11-07,2659.84,2675.68,2639.25,2641.34,173201986.0,-18.019999999999985,18.019999999999985,0.0,54.07686340716778,2449.2,2676.48,84.5388947553679,-15.461105244632105,-10.073083884034531,-23.36747661463017,0.0144173899685076,40028763181.0,0
2150,2018-11-08,2660.09,2662.37,2632.3,2635.63,159635487.0,-5.710000000000036,5.710000000000036,0.0,52.45987450381304,2521.78,2676.48,73.59405300581774,-26.405946994182266,-8.62808078889293,-20.41959744948273,0.0141524135675394,39869127694.0,0
2151,2018-11-09,2621.24,2621.24,2598.16,2598.87,152446307.0,-36.76000000000022,36.76000000000022,0.0,42.92539216137192,2521.78,2676.48,49.8319327731091,-50.1680672268909,-10.3300518022279,-18.401688320031763,0.0223319302938516,39716681387.0,0
2152,2018-11-12,2593.2,2631.17,2590.21,2630.52,175031308.0,31.65000000000009,0.0,31.65000000000009,51.65453723900375,2521.78,2676.48,70.29088558500317,-29.70911441499683,-9.020997162507683,-16.52555008852695,0.0243258503533809,39891712695.0,1
2153,2018-11-13,2600.5,2666.49,2597.35,2654.88,249282447.0,24.360000000000127,0.0,24.360000000000127,57.43582365332917,2521.78,2676.48,86.0374919198449,-13.962508080155098,-5.949333303324693,-14.410306731486497,0.0200170586834076,40140995142.0,1
2154,2018-11-14,2648.31,2658.31,2627.96,2632.24,238449351.0,-22.640000000000327,22.640000000000327,0.0,50.90755459983758,2521.78,2676.48,71.40271493212651,-28.59728506787349,-5.281000270594177,-12.584445439308032,0.009976057462091,39902545791.0,0
2155,2018-11-15,2632.14,2668.17,2631.89,2668.17,207848721.0,35.93000000000029,0.0,35.93000000000029,59.36507985965651,2521.78,2676.48,94.628312863607,-5.37168713639299,-1.8309843586753232,-10.43375322318149,-0.0031048242467718,40110394512.0,1
2156,2018-11-16,2669.78,2695.57,2657.03,2679.11,242198849.0,10.940000000000056,0.0,10.940000000000056,61.68415619134119,2521.78,2695.57,90.52879912538118,-9.471200874618816,1.7655920322431484,-7.993884172096562,0.0051323801412905,40352593361.0,1
2157,2018-11-19,2681.9,2703.51,2674.18,2703.51,231662827.0,24.40000000000009,0.0,24.40000000000009,66.59097326832295,2567.03,2703.51,100.0,-0.0,6.5097405774668005,-5.093159222183889,0.0166017387642138,40584256188.0,1
2158,2018-11-20,2684.29,2690.83,2643.36,2645.85,215891309.0,-57.66000000000031,57.66000000000031,0.0,49.35648433156652,2590.21,2703.51,49.10856134157086,-50.891438658429145,5.5528228783973645,-2.963962802067638,0.0017074666646474,40368364879.0,0
2159,2018-11-21,2619.82,2653.8,2617.78,2651.51,182596447.0,5.660000000000309,0.0,5.660000000000309,50.79876167251683,2590.21,2703.51,54.10414827890564,-45.89585172109437,5.191330973103959,-1.3329040470333184,0.0060251249226941,40550961326.0,1
2160,2018-11-22,2655.9,2658.0,2634.48,2645.43,149309063.0,-6.080000000000382,6.080000000000382,0.0,49.06676360959393,2590.21,2703.51,48.73786407766965,-51.26213592233035,4.363936107440622,-0.1935360161385299,0.0179154786503363,40401652263.0,0
2161,2018-11-23,2640.67,2642.04,2577.35,2579.48,191474549.0,-65.94999999999982,65.94999999999982,0.0,34.391059208191706,2577.35,2703.51,1.6883322764744009,-98.3116677235256,-1.5950078597597894,-0.4738303848627819,-0.0194030077703267,40210177714.0,0
2162,2018-11-26,2580.84,2595.0,2568.04,2575.81,134314540.0,-3.6700000000000728,3.6700000000000728,0.0,33.74302969189135,2568.04,2703.51,5.735587214881499,-94.2644127851185,-6.538282958167201,-1.6867208995236662,-0.0297828903754595,40075863174.0,0
2163,2018-11-27,2585.83,2592.54,2566.17,2574.68,123658436.0,-1.1300000000001091,1.1300000000001091,0.0,33.51864358832751,2566.17,2703.51,6.196301150429412,-93.80369884957058,-10.426851391868697,-3.4347469979926726,-0.0218673069324984,39952204738.0,0
2164,2018-11-28,2575.45,2601.96,2561.56,2601.74,145963473.0,27.059999999999945,0.0,27.059999999999945,43.83798176033154,2561.56,2703.51,28.30574145825978,-71.69425854174023,-11.19599359614358,-4.986996317622855,-0.0248972141954973,40098168211.0,1
2165,2018-11-29,2613.78,2617.55,2567.44,2567.44,157168738.0,-34.29999999999973,34.29999999999973,0.0,35.72716236074834,2561.56,2703.51,4.142303628038111,-95.8576963719619,-14.407190552813065,-6.871035164660898,-0.0416817525222928,39940999473.0,0
2166,2018-11-30,2564.56,2590.21,2555.32,2588.19,139329021.0,20.75,0.0,20.75,43.07844053991129,2555.32,2703.51,22.18098387205606,-77.81901612794394,-15.1036304413401,-8.51755421999674,-0.0426556587547299,40080328494.0,1
2167,2018-12-03,2647.13,2665.3,2629.18,2654.8,207478955.0,66.61000000000013,0.0,66.61000000000013,60.01709660155333,2555.32,2703.51,67.1300357648964,-32.869964235103595,-10.163534850399174,-8.846750346077227,0.003382655857286,40287807449.0,1
2168,2018-12-04,2651.56,2666.08,2644.9,2665.96,167940558.0,11.159999999999854,0.0,11.159999999999854,62.1920878928266,2555.32,2703.51,74.660908293407,-25.339091706593003,-5.2870094176059865,-8.134802160382979,0.005449724873751,40455748007.0,1
2169,2018-12-05,2629.83,2660.39,2625.91,2649.81,154502056.0,-16.15000000000009,16.15000000000009,0.0,57.013436766829706,2555.32,2703.51,63.762737026789765,-36.23726297321024,-2.694438102253571,-7.046729348757097,0.0016556854651228,40301245951.0,0
2170,2018-12-06,2629.82,2633.68,2603.13,2605.18,141661650.0,-44.63000000000011,44.63000000000011,0.0,45.05168417885457,2555.32,2703.51,33.64599500641046,-66.35400499358954,-4.192743332650025,-6.475932145535682,0.0099632484066556,40159584301.0,0
2171,2018-12-07,2609.34,2614.58,2599.28,2605.89,109074993.0,0.7100000000000364,0.0,0.7100000000000364,45.26248971051133,2555.32,2690.83,37.31827909379366,-62.68172090620633,-5.262210469482852,-6.233187810325117,0.0116778799678547,40268659294.0,1
2172,2018-12-10,2589.19,2599.76,2576.24,2584.58,113199669.0,-21.309999999999945,21.309999999999945,0.0,39.9541088646069,2555.32,2666.08,26.417479234380487,-73.58252076561952,-7.740086881879506,-6.534567624635996,0.0038451380365716,40155459625.0,0
2173,2018-12-11,2587.01,2596.15,2583.2,2594.09,101304364.0,9.510000000000218,0.0,9.510000000000218,43.37379364547,2555.32,2666.08,35.00361141206218,-64.99638858793783,-8.834604448493337,-6.9945749894074645,-0.0029403399263567,40256763989.0,1
2174,2018-12-12,2608.11,2610.01,2595.07,2602.15,103518301.0,8.059999999999945,0.0,8.059999999999945,46.36113461744097,2555.32,2666.08,42.28060671722646,-57.71939328277354,-8.94849024058658,-7.385358039643287,0.0135193032748575,40360282290.0,1
2175,2018-12-13,2607.14,2645.84,2599.46,2634.05,150738115.0,31.90000000000009,0.0,31.90000000000009,56.774882488990215,2555.32,2666.08,71.081617912604,-28.918382087396004,-6.39101055928586,-7.186488543571802,0.0177189464451992,40511020405.0,1
2176,2018-12-14,2627.28,2629.16,2593.74,2593.74,145942488.0,-40.3100000000004,40.3100000000004,0.0,44.24916577612956,2555.32,2666.08,34.68761285662667,-65.31238714337333,-7.530067668702486,-7.255204368597938,-0.0229998493295164,40365077917.0,0
2177,2018-12-17,2587.26,2598.97,2573.87,2597.97,117363250.0,4.230000000000018,0.0,4.230000000000018,45.69968720327336,2555.32,2666.08,38.506681112314666,-61.49331888768533,-7.999242695524572,-7.404012033983265,-0.0255030082971988,40482441167.0,1
2178,2018-12-18,2583.63,2599.15,2563.57,2576.65,117033370.0,-21.31999999999971,21.31999999999971,0.0,39.693643562087054,2555.32,2666.08,19.25785482123508,-80.74214517876493,-9.976411247074791,-7.918491876601571,-0.0276095267207836,40365407797.0,0
2179,2018-12-19,2578.68,2579.87,2547.08,2549.56,107661797.0,-27.090000000000146,27.090000000000146,0.0,33.28094758593592,2547.08,2666.08,2.0840336134453934,-97.91596638655462,-13.572809271826372,-9.049355355646531,-0.0213497723765727,40257746000.0,0
2180,2018-12-20,2544.51,2554.86,2516.02,2536.27,120566496.0,-13.289999999999964,13.289999999999964,0.0,30.492416966379366,2516.02,2666.08,13.49460215913635,-86.50539784086365,-17.29599508299316,-10.698683301115858,-0.0267164001550334,40137179504.0,0
2181,2018-12-21,2526.55,2527.42,2498.69,2516.25,115671200.0,-20.019999999999985,20.019999999999985,0.0,26.616163332558344,2498.69,2666.08,10.490471354322215,-89.50952864567779,-21.612952683389267,-12.881537177570545,-0.0264375643237972,40021508304.0,0
2182,2018-12-24,2506.74,2529.44,2500.44,2527.01,97339852.0,10.760000000000218,0.0,10.760000000000218,31.978598073208005,2498.69,2660.39,17.51391465677192,-82.48608534322808,-23.890535388161425,-15.08333681968872,-0.0258587789937897,40118848156.0,1
2183,2018-12-25,2503.95,2513.96,2462.84,2504.82,140670560.0,-22.19000000000005,22.19000000000005,0.0,27.241749153052908,2462.84,2645.84,22.939890710382524,-77.06010928961747,-27.172851918815923,-17.501239839514167,-0.0374036854139845,39978177596.0,0
2184,2018-12-26,2501.12,2513.83,2492.08,2498.29,108799629.0,-6.5300000000002,6.5300000000002,0.0,25.93720988916415,2462.84,2645.84,19.371584699453454,-80.62841530054655,-29.955716985068648,-19.992135268625063,-0.0515404035610562,39869377967.0,0
2185,2018-12-27,2527.72,2532.0,2483.09,2483.09,135406843.0,-15.199999999999818,15.199999999999818,0.0,22.98139720845721,2462.84,2645.84,11.065573770491802,-88.9344262295082,-33.00718429355675,-22.5951450736114,-0.0426604054377075,39733971124.0,0
2186,2018-12-28,2483.62,2505.11,2478.32,2493.9,119245250.0,10.809999999999944,0.0,10.809999999999944,29.567891977312826,2462.84,2645.84,16.972677595628387,-83.02732240437162,-34.15944860312948,-24.90800577951502,-0.0400581992863657,39853216374.0,1
2187,2019-01-02,2497.88,2500.28,2456.42,2465.29,109932013.0,-28.610000000000127,28.610000000000127,0.0,23.44508467282029,2456.42,2645.84,4.682715658325355,-95.31728434167464,-36.95521752255945,-27.317448128123907,-0.0432189082723691,39743284361.0,0
2188,2019-01-03,2461.78,2488.48,2455.93,2464.36,124397497.0,-0.9299999999998364,0.9299999999998364,0.0,23.264394315603084,2455.93,2645.84,4.438944763309082,-95.56105523669092,-38.79868072128602,-29.613694646756333,-0.0334175308680713,39618886864.0,0
2189,2019-01-04,2446.02,2515.32,2440.91,2514.87,168877667.0,50.50999999999976,0.0,50.50999999999976,48.25566380107022,2440.91,2629.16,39.2881806108898,-60.71181938911021,-35.77155153827971,-30.84526602506101,-0.0084375874808282,39787764531.0,1
2190,2019-01-07,2528.7,2536.98,2515.51,2533.09,177305010.0,18.22000000000025,0.0,18.22000000000025,54.43249274454007,2440.91,2599.15,58.25328614762396,-41.74671385237604,-31.53876882751092,-30.983966585550995,0.0066924987580725,39965069541.0,1
2191,2019-01-08,2530.3,2531.34,2520.16,2526.46,158099181.0,-6.630000000000109,6.630000000000109,0.0,51.83451824732414,2440.91,2599.15,54.06344792719923,-45.93655207280077,-28.39195879682302,-30.465565027805404,-0.0002176485253323,39806970360.0,0
2192,2019-01-09,2536.42,2574.41,2536.16,2544.34,191887930.0,17.88000000000011,0.0,17.88000000000011,58.06292153370724,2440.91,2579.87,74.43149107656899,-25.56850892343101,-24.176629470251555,-29.20777791629464,0.0157775808241709,39998858290.0,1
2193,2019-01-10,2543.85,2551.83,2531.66,2535.1,159874326.0,-9.240000000000236,9.240000000000236,0.0,53.90636912252664,2440.91,2574.41,70.55430711610491,-29.44569288389509,-21.335597895641968,-27.63334191216411,0.0147340781094267,39838983964.0,0
2194,2019-01-11,2539.55,2554.79,2533.36,2553.83,149444100.0,18.730000000000015,0.0,18.730000000000015,60.51719982590973,2440.91,2574.41,84.5842696629214,-15.415730337078598,-17.3724466859544,-25.581162866922167,0.0284886975502296,39988428064.0,1
2195,2019-01-14,2553.33,2556.29,2533.01,2535.77,144825464.0,-18.059999999999945,18.059999999999945,0.0,52.18948239192693,2440.91,2574.41,71.056179775281,-28.94382022471901,-15.51012084718559,-23.566954462974856,0.0167889650747823,39843602600.0,0
2196,2019-01-15,2537.37,2571.5,2532.43,2570.34,160265530.0,34.570000000000164,0.0,34.570000000000164,63.33358586291239,2440.91,2574.41,96.95131086142344,-3.048689138576561,-11.116559339919604,-21.076875438363807,0.0426116197283079,40003868130.0,1
2197,2019-01-16,2569.07,2574.24,2563.01,2570.42,149301539.0,0.0799999999999272,0.0,0.0799999999999272,63.356392351753385,2440.91,2574.41,97.01123595505634,-2.988764044943657,-7.541244092461511,-18.369749169183347,0.0430375432160885,40153169669.0,1
2198,2019-01-17,2573.58,2582.56,2557.71,2559.64,162468134.0,-10.7800000000002,10.7800000000002,0.0,57.76955893811618,2440.91,2582.56,83.81927285563003,-16.180727144369968,-5.514074094111948,-15.798614154169067,0.0178021130316874,39990701535.0,0
2199,2019-01-18,2567.74,2598.88,2565.9,2596.01,190767237.0,36.370000000000346,0.0,36.370000000000346,68.5616846425381,2440.91,2598.88,98.18319934164722,-1.81680065835278,-0.9616864988906856,-12.831228623113391,0.0248392279784768,40181468772.0,1
2200,2019-01-21,2599.06,2618.98,2599.06,2610.51,163425115.0,14.5,0.0,14.5,71.86875162325698,2440.91,2618.98,95.2434435895997,-4.756556410400288,3.772653485956198,-9.510452201299474,0.0332678926244627,40344893887.0,1
2201,2019-01-22,2609.64,2609.64,2573.06,2579.7,152537773.0,-30.8100000000004,30.8100000000004,0.0,57.13380745100617,2440.91,2618.98,77.94125905542755,-22.05874094457245,4.981123234928418,-6.612137114053895,0.0138975136970687,40192356114.0,0
2202,2019-01-23,2575.26,2589.51,2572.41,2581.0,131426798.0,1.300000000000182,0.0,1.300000000000182,57.557459514368574,2440.91,2618.98,78.67130903577247,-21.328690964227544,5.974868784864157,-4.094735934270284,0.0181057946432092,40323782912.0,1
2203,2019-01-24,2584.65,2597.29,2569.7,2591.69,154042046.0,10.690000000000056,0.0,10.690000000000056,61.196198849448095,2515.51,2618.98,73.62520537353821,-26.3747946264618,7.53811821817726,-1.7681651037807746,0.014824792566459,40477824958.0,1
2204,2019-01-25,2596.26,2617.0,2595.63,2601.72,159394026.0,10.029999999999744,0.0,10.029999999999744,64.49190221660601,2520.16,2618.98,82.53390002023863,-17.466099979761374,9.47709577170599,0.480887071316579,0.0260078792634979,40637218984.0,1
2205,2019-01-28,2615.71,2630.32,2591.1,2596.98,146981765.0,-4.739999999999782,4.739999999999782,0.0,61.63731778822703,2531.66,2630.32,66.20717616055136,-33.79282383944865,10.510116980062776,2.48673305306582,0.0103643875907466,40490237219.0,0
2206,2019-01-29,2592.35,2601.74,2559.98,2594.25,155581112.0,-2.730000000000018,2.730000000000018,0.0,59.876059188282255,2531.66,2630.32,63.44009730387184,-36.55990269612816,10.981912889972136,4.185769020447084,0.0092708584589289,40334656107.0,0
2207,2019-01-30,2584.75,2598.81,2575.41,2575.58,120502571.0,-18.670000000000076,18.670000000000076,0.0,48.85925121366057,2532.43,2630.32,44.08008989682291,-55.919910103177095,9.737058826340215,5.296026981625711,0.0062274382335016,40214153536.0,0
2208,2019-01-31,2581.33,2606.63,2571.58,2584.57,154303869.0,8.990000000000236,0.0,8.990000000000236,53.602346687384085,2532.43,2630.32,53.26386760649724,-46.73613239350276,9.36793317732554,6.110408220765677,-0.0044067626858139,40368457405.0,1
2209,2019-02-01,2597.78,2618.48,2590.55,2618.23,131986850.0,33.659999999999854,0.0,33.659999999999854,66.87489629771399,2532.43,2630.32,87.64940239043814,-12.35059760956186,11.65710330214506,7.219747237041555,0.0029572765474945,40500444255.0,1
2210,2019-02-11,2613.17,2654.1,2613.17,2653.9,154898858.0,35.67000000000007,0.0,35.67000000000007,75.45889084972995,2557.71,2654.1,99.79250959643136,-0.2074904035686464,16.163238262591676,9.00844544215158,0.0287630344613716,40655343113.0,1
2211,2019-02-12,2654.03,2674.48,2648.83,2671.89,184101179.0,17.98999999999978,0.0,17.98999999999978,78.67478384321151,2557.71,2674.48,97.78196454568798,-2.21803545431202,20.94458914883808,11.39567418348888,0.0352150329329716,40839444292.0,1
2212,2019-02-13,2674.52,2727.07,2666.52,2721.07,243794010.0,49.18000000000029,0.0,49.18000000000029,84.91152802746237,2559.98,2727.07,96.40912083308396,-3.59087916691603,28.375167887078533,14.791572924206816,0.0499210939579966,41083238302.0,1
2213,2019-02-14,2715.54,2729.46,2707.49,2719.7,197037349.0,-1.3700000000003456,1.3700000000003456,0.0,84.12076266156207,2559.98,2729.46,94.2412084021712,-5.758791597828781,33.76419489980708,18.58609731932687,0.0453469243423581,40886200953.0,0
2214,2019-02-15,2712.79,2715.63,2679.78,2682.39,196004265.0,-37.309999999999945,37.309999999999945,0.0,65.07671722297292,2559.98,2729.46,72.22681142317668,-27.77318857682332,34.62529361462475,21.79393657838645,0.0328882009102879,40690196688.0,0
2215,2019-02-18,2699.82,2754.36,2699.82,2754.36,260436007.0,71.97000000000025,0.0,71.97000000000025,76.77793396102417,2559.98,2754.36,100.0,-0.0,40.646549945441166,25.5644592517974,0.061717259323504,40950632695.0,1
2216,2019-02-19,2759.5,2780.78,2737.59,2755.65,288046271.0,1.2899999999999636,0.0,1.2899999999999636,76.93774393014102,2559.98,2780.78,88.61865942028982,-11.381340579710184,45.00375590325484,29.45231858208889,0.0699143493892637,41238678966.0,1
2217,2019-02-20,2761.06,2767.41,2739.98,2761.22,245972527.0,5.569999999999709,0.0,5.569999999999709,77.7022440557286,2559.98,2780.78,91.14130434782592,-8.858695652174086,48.34898842401208,33.23165255047353,0.0683479263475161,41484651493.0,1
2218,2019-02-21,2759.94,2794.01,2744.98,2751.8,298649969.0,-9.419999999999618,9.419999999999618,0.0,72.9812782875711,2559.98,2794.01,81.96385078836047,-18.036149211639533,49.66745847960192,36.51881373629921,0.0510153806197317,41186001524.0,0
2219,2019-02-22,2749.46,2804.23,2736.33,2804.23,301481411.0,52.42999999999984,0.0,52.42999999999984,80.56470241887254,2559.98,2804.23,100.0,-0.0,54.31688705900024,40.07842840083941,0.0566449376389464,41487482935.0,1
2220,2019-02-25,2838.39,2961.8,2838.39,2961.28,528658590.0,157.05000000000018,0.0,157.05000000000018,90.13475599682972,2571.58,2961.8,99.86674183793758,-0.1332581620624215,69.86881102224424,46.03650492512038,0.1083090995512541,42016141525.0,1
2221,2019-02-26,2969.1,2995.68,2938.62,2941.52,565557967.0,-19.76000000000022,19.76000000000022,0.0,84.12127520136366,2571.58,2995.68,87.22942702192881,-12.77057297807118,79.68084477097091,52.76537289429049,0.0810159238828842,41450583558.0,0
2222,2019-02-27,2939.93,2997.49,2924.64,2953.82,474976453.0,12.300000000000182,0.0,12.300000000000182,84.84736108448554,2590.55,2997.49,89.26868825871144,-10.73131174128856,87.44148836588874,59.70059598861016,0.0860830238629262,41925560011.0,1
2223,2019-02-28,2950.05,2965.3,2930.2,2940.95,350206602.0,-12.870000000000346,12.870000000000346,0.0,80.40826636279877,2613.17,2997.49,85.28830141548708,-14.711698584512908,91.49861382212475,66.06019955531308,0.0963916507293869,41575353409.0,0
2224,2019-03-01,2954.4,2994.0,2930.83,2994.0,345786200.0,53.05000000000018,0.0,53.05000000000018,84.31198722082674,2648.83,2997.49,98.99902483795108,-1.0009751620489251,97.86646295368064,72.42145223498659,0.0870038774887813,41921139609.0,1
2225,2019-03-04,3015.94,3090.8,3006.94,3027.58,525649436.0,33.57999999999993,0.0,33.57999999999993,86.30500421054349,2666.52,3090.8,85.09946261902512,-14.900537380974882,104.41897765272095,78.82095731853347,0.0986808919855568,42446789045.0,1
2226,2019-03-05,3019.88,3054.96,3009.45,3054.25,424142529.0,26.670000000000076,0.0,26.670000000000076,87.73313176166567,2679.78,3090.8,91.10748868668188,-8.892511313318131,110.49027574851972,85.15482100453073,0.1061233802449643,42870931574.0,1
2227,2019-03-06,3060.43,3103.83,3050.11,3102.1,555006365.0,47.84999999999991,0.0,47.84999999999991,89.91111733538446,2679.78,3103.83,99.5920292418347,-0.4079707581653153,117.80493635635594,91.68484407489578,0.1272984955301983,43425937939.0,1
2228,2019-03-07,3103.67,3129.94,3074.98,3106.42,583817065.0,4.320000000000164,0.0,4.320000000000164,90.09432974089422,2699.82,3129.94,94.5317585790012,-5.468241420998788,122.537904794332,97.85545621878305,0.1077622021018247,44009755004.0,1
2229,2019-03-08,3038.34,3075.05,2969.58,2969.86,577855473.0,-136.55999999999997,136.55999999999997,0.0,54.19637464157979,2736.33,3129.94,59.33030156754151,-40.669698432458496,113.95595237628686,101.07555545028382,0.0028973957207694,43431899531.0,0
2230,2019-03-11,2969.08,3028.25,2963.58,3026.99,426213029.0,57.12999999999965,0.0,57.12999999999965,61.58497239637978,2736.33,3129.94,73.84466858057462,-26.15533141942538,110.49093606726184,102.95863157367944,0.0290564062117544,43858112560.0,1
2231,2019-03-12,3049.08,3093.39,3029.9,3060.31,511173158.0,33.320000000000164,0.0,33.320000000000164,65.34676328720988,2736.33,3129.94,82.30990066309289,-17.690099336907114,109.17502943121964,104.20191114518748,0.0360516212903967,44369285718.0,1
2232,2019-03-13,3062.33,3065.29,3013.93,3026.95,453214625.0,-33.36000000000013,33.36000000000013,0.0,58.70562981714642,2736.33,3129.94,73.83450623713823,-26.165493762861768,104.23869198781132,104.20926731371225,0.0292422516533772,43916071093.0,0
2233,2019-03-14,3013.6,3041.16,2968.82,2990.69,373141798.0,-36.25999999999976,36.25999999999976,0.0,52.06900765898616,2838.39,3129.94,52.23803807237184,-47.76196192762816,96.29075020750132,102.62556389247008,-0.0011055444221776,43542929295.0,0
2234,2019-03-15,3000.88,3048.12,2999.43,3021.75,341206139.0,31.059999999999945,0.0,31.059999999999945,56.88631189540686,2924.64,3129.94,47.301509985387256,-52.69849001461274,91.4441206051788,100.38927523501184,-0.0019256303714517,43884135434.0,1
2235,2019-03-18,3027.8,3096.42,3009.51,3096.42,397797179.0,74.67000000000007,0.0,74.67000000000007,66.285612433055,2924.64,3129.94,83.67267413541161,-16.327325864588385,92.56138663634874,98.82369751527924,0.0138069902594746,44281932613.0,1
2236,2019-03-19,3099.9,3113.43,3076.36,3090.98,350908860.0,-5.440000000000055,5.440000000000055,0.0,65.09268722309709,2930.2,3129.94,80.49464303594674,-19.505356964053263,91.94794678457174,97.44854736913774,-0.0035846684504045,43931023753.0,0
2237,2019-03-20,3084.17,3102.52,3053.45,3090.64,358557505.0,-0.3400000000001455,0.3400000000001455,0.0,65.00831669098824,2930.83,3129.94,80.26216664155484,-19.73783335844516,90.39236915956644,96.0373117272235,-0.0050798024735869,43572466248.0,0
2238,2019-03-21,3094.12,3125.02,3086.85,3101.46,414251182.0,10.820000000000164,0.0,10.820000000000164,66.59805833497195,2963.58,3129.94,82.88050012022121,-17.11949987977879,89.0066331951366,94.63117602080612,0.0443118530839836,43986717430.0,1
2239,2019-03-22,3100.73,3107.28,3064.88,3104.15,364848346.0,2.6900000000000546,0.0,2.6900000000000546,67.02777568366912,2963.58,3129.94,84.4974753546526,-15.502524645347409,87.12120891308905,93.12918259926272,0.0254906689483613,44351565776.0,1
2240,2019-03-25,3058.8,3087.0,3041.95,3043.03,380278762.0,-61.11999999999989,61.11999999999989,0.0,50.122482136304434,2963.58,3129.94,47.75787448906,-52.24212551094001,79.77552084125045,90.45845024766028,-0.0056464867938214,43971287014.0,0
2241,2019-03-26,3057.56,3062.69,2988.49,2997.1,353498021.0,-45.93000000000029,45.93000000000029,0.0,41.12816411627298,2963.58,3129.94,20.149074296705912,-79.85092570329408,69.44729775543647,86.25621974921553,-0.0098614116519929,43617788993.0,0
2242,2019-03-27,3012.26,3022.76,2987.77,3022.72,291390357.0,25.61999999999989,0.0,25.61999999999989,47.22361574661815,2963.58,3125.02,36.63280475718524,-63.36719524281476,62.60772356848338,81.5265205130691,0.0107099030658475,43909179350.0,1
2243,2019-03-28,3009.8,3025.78,2991.78,2994.94,288106425.0,-27.779999999999745,27.779999999999745,0.0,41.8078798533858,2963.58,3125.02,19.425173439048635,-80.57482656095137,54.31953611638619,76.08512363373252,-0.0088723421858194,43621072925.0,0
2244,2019-03-29,3000.68,3093.03,2999.99,3090.76,375082991.0,95.82000000000016,0.0,95.82000000000016,60.044566029308,2968.82,3125.02,78.06658130601805,-21.93341869398195,54.85067658991329,71.83823422496867,-0.0018279174013861,43996155916.0,1
2245,2019-04-01,3111.66,3176.62,3111.66,3170.36,466124693.0,79.59999999999991,0.0,79.59999999999991,69.27428618378119,2968.82,3176.62,96.98748796920128,-3.012512030798735,60.99159090290459,69.66890556055586,0.0256811755495021,44462280609.0,1
2246,2019-04-02,3183.27,3193.27,3164.91,3176.82,447068981.0,6.460000000000036,0.0,6.460000000000036,69.92484697344153,2968.82,3193.27,92.67097349075526,-7.329026509244746,65.62311532587046,68.85974751361879,0.0278841922708565,44909349590.0,1
2247,2019-04-03,3159.15,3219.26,3152.33,3216.3,430548635.0,39.48000000000002,0.0,39.48000000000002,73.83191033988084,2987.77,3219.26,98.72132705516437,-1.2786729448356444,71.65336249114716,69.41847050912446,0.0370277224275019,45339898225.0,1
2248,2019-04-04,3233.69,3254.14,3216.85,3246.57,469117669.0,30.269999999999985,0.0,30.269999999999985,76.52934538395706,2987.77,3254.14,97.15808837331542,-2.8419116266845785,77.97605343270425,71.12998709384043,0.0458805147947103,45809015894.0,1
2249,2019-04-08,3271.27,3288.45,3210.52,3244.81,504518403.0,-1.7600000000002185,1.7600000000002185,0.0,76.00373724963444,2987.77,3288.45,85.48623120925905,-14.513768790740952,81.9007138178822,73.28413243864878,0.0663089092121995,45304497491.0,0
2250,2019-04-09,3240.39,3251.65,3215.7,3239.66,364169997.0,-5.150000000000091,5.150000000000091,0.0,74.28125102782265,2987.77,3288.45,83.77344685379806,-16.226553146201937,83.63142250919964,75.35359045275895,0.0809315671816088,44940327494.0,0
2251,2019-04-10,3224.65,3264.78,3204.88,3241.93,380134408.0,2.269999999999982,0.0,2.269999999999982,74.57431338167497,2987.77,3288.45,84.52840228814686,-15.471597711853136,84.21540883420084,77.12595412904733,0.0725207759898369,45320461902.0,1
2252,2019-04-11,3241.55,3254.13,3185.55,3189.96,353031879.0,-51.9699999999998,51.9699999999998,0.0,57.320199700166334,2987.77,3288.45,67.24424637488366,-32.75575362511635,79.5674732331704,77.61425794987196,0.0651164964907478,44967430023.0,0
2253,2019-04-12,3184.86,3199.28,3168.04,3188.63,289788996.0,-1.3299999999999272,1.3299999999999272,0.0,56.93124332772892,2987.77,3288.45,66.8019156578423,-33.1980843421577,74.9130795487954,77.07402226965665,0.0316653509169264,44677641027.0,0
2254,2019-04-15,3233.46,3253.98,3177.27,3177.79,348809785.0,-10.840000000000146,10.840000000000146,0.0,53.51614238584301,2987.77,3288.45,63.19675402421181,-36.80324597578819,69.54803515734648,75.56882484719462,0.0023435824322788,44328831242.0,0
2255,2019-04-16,3164.4,3253.6,3153.21,3253.6,357918752.0,75.80999999999995,0.0,75.80999999999995,68.67788400045856,2987.77,3288.45,88.40960489557006,-11.590395104429934,70.59960396567203,74.5749806708901,0.0241688229109611,44686749994.0,1
2256,2019-04-17,3250.15,3275.33,3239.8,3263.12,357541796.0,9.519999999999982,0.0,9.519999999999982,70.09140199929263,2991.78,3288.45,91.4618936865878,-8.538106313412195,71.37835896973638,73.93565633065936,0.0145570997730311,45044291790.0,1
2257,2019-04-18,3261.07,3271.39,3241.83,3250.2,325539942.0,-12.920000000000073,12.920000000000073,0.0,65.46510420514642,2999.99,3288.45,86.73992927962283,-13.260070720377174,70.14441079377866,73.17740722328323,0.0011181031057392,44718751848.0,0
2258,2019-04-19,3250.15,3274.33,3226.81,3270.8,315198004.0,20.600000000000364,0.0,20.600000000000364,69.20455586282309,3111.66,3288.45,90.01640364274017,-9.983596357259822,70.02158061838463,72.5462419023035,0.0080097139740078,45033949852.0,1
2259,2019-04-22,3278.49,3279.49,3206.88,3215.04,353217387.0,-55.76000000000022,55.76000000000022,0.0,51.71527166067628,3152.33,3288.45,46.06964443138414,-53.93035556861586,64.67928825169838,70.97285117218249,-0.0075995629170961,44680732465.0,0
2260,2019-04-23,3211.87,3231.58,3186.76,3198.59,328361207.0,-16.449999999999818,16.449999999999818,0.0,47.6188270508648,3152.33,3288.45,33.98471936526613,-66.01528063473387,58.44439493589925,68.46715992492584,-0.0133685798274483,44352371258.0,0
2261,2019-04-24,3203.56,3210.65,3156.61,3201.61,274872164.0,3.019999999999982,0.0,3.019999999999982,48.48324881159208,3153.21,3288.45,35.78822833481231,-64.21177166518768,53.134385700604525,65.40060508006158,0.0036520834117041,44627243422.0,1
2262,2019-04-25,3190.59,3193.75,3123.03,3123.83,325879129.0,-77.7800000000002,77.7800000000002,0.0,32.53014050387657,3123.03,3288.45,0.4836174585900913,-99.51638254140993,42.16392962508189,60.75326998906564,-0.0203222073429655,44301364293.0,0
2263,2019-04-26,3108.16,3129.21,3085.8,3086.4,280873854.0,-37.42999999999984,37.42999999999984,0.0,27.504835293791476,3085.8,3279.49,0.309773349166147,-99.69022665083386,30.102473387848026,54.62311066882212,-0.0287589802976281,44020490439.0,0
2264,2019-04-29,3090.63,3107.76,3050.03,3062.5,292114886.0,-23.90000000000009,23.90000000000009,0.0,24.69424095831461,3050.03,3279.49,5.4344983875184445,-94.56550161248155,18.403013676193492,47.37909127029639,-0.0587349397590361,43728375553.0,0
2265,2019-04-30,3052.62,3088.41,3052.62,3078.34,222302517.0,15.840000000000146,0.0,15.840000000000146,30.152395372820838,3050.03,3279.49,12.337662337662335,-87.66233766233766,10.290639102376645,39.96140083671244,-0.0566267866336511,43950678070.0,1
2266,2019-05-06,2984.73,2986.54,2876.47,2906.46,326972269.0,-171.8800000000001,171.8800000000001,0.0,15.807473893401522,2876.47,3279.49,7.441318048732132,-92.55868195126786,-9.893707234401973,29.99037922248956,-0.1057596455602731,43623705801.0,0
2267,2019-05-07,2914.29,2937.28,2889.07,2926.39,253281769.0,19.92999999999984,0.0,19.92999999999984,20.845733541086677,2876.47,3279.49,12.386482060443669,-87.61351793955633,-24.005047444306456,19.191293889130357,-0.1052983979454568,43876987570.0,1
2268,2019-05-08,2873.14,2929.43,2866.7,2893.76,231530519.0,-32.629999999999654,32.629999999999654,0.0,18.72850474501311,2866.7,3279.49,6.555391361224934,-93.44460863877508,-37.39034193988027,7.8749667233282254,-0.0999303274609335,43645457051.0,0
2269,2019-05-09,2871.2,2888.86,2845.04,2850.95,200041133.0,-42.8100000000004,42.8100000000004,0.0,16.232665993881213,2845.04,3279.49,1.36034066060533,-98.63965933939468,-50.866338004048885,-3.8732942221472,-0.1086853894997483,43445415918.0,0
2270,2019-05-10,2878.23,2941.45,2838.38,2939.21,282306808.0,88.26000000000022,0.0,88.26000000000022,36.396074196168335,2838.38,3279.49,22.858243975425637,-77.14175602457438,-53.80409745028919,-13.859454867775602,-0.0819587644966126,43727722726.0,1
2271,2019-05-13,2905.07,2921.41,2892.17,2903.71,212029882.0,-35.5,35.5,0.0,32.73874833575526,2838.38,3279.49,14.81036476162408,-85.18963523837591,-58.3245175583088,-22.752467405882246,-0.0704647820143861,43515692844.0,0
2272,2019-05-14,2872.83,2909.2,2872.83,2883.61,208345353.0,-20.09999999999991,20.09999999999991,0.0,30.72190193338848,2838.38,3279.49,10.253678220851953,-89.74632177914805,-62.80490918073656,-30.76295576085312,-0.0657043805080352,43307347491.0,0
2273,2019-05-15,2902.64,2945.39,2902.64,2938.68,230519701.0,55.06999999999971,0.0,55.06999999999971,42.014569964435175,2838.38,3231.58,25.50864699898265,-74.49135300101734,-61.20641362359902,-36.8516473334023,-0.0404310204081632,43537867192.0,1
2274,2019-05-16,2933.5,2956.17,2929.06,2955.71,248385701.0,17.0300000000002,0.0,17.0300000000002,45.20180670738419,2838.38,3210.65,31.517447014263823,-68.48255298573618,-57.89800355890566,-41.06091857850297,-0.0398364053353431,43786252893.0,1
2275,2019-05-17,2955.77,2956.78,2873.8,2882.3,266301643.0,-73.40999999999985,73.40999999999985,0.0,35.497198566608404,2838.38,3193.75,12.35894982694096,-87.64105017305904,-60.50220645911622,-44.949176154625626,-0.0083125176331344,43519951250.0,0
2276,2019-05-20,2874.8,2882.63,2838.45,2870.6,209472442.0,-11.700000000000273,11.700000000000273,0.0,34.148925683676524,2838.38,3129.21,11.078637004435516,-88.9213629955645,-62.78638586572925,-48.51661809684636,-0.0190644445887253,43310478808.0,0
2277,2019-05-21,2867.71,2919.24,2862.5,2905.97,211387022.0,35.36999999999989,0.0,35.36999999999989,41.85280693121652,2838.38,3107.76,25.09094958794256,-74.90905041205744,-61.0389322855458,-51.02108093458625,0.0042194238637618,43521865830.0,1
2278,2019-05-22,2905.52,2912.4,2879.64,2891.7,200026905.0,-14.269999999999982,14.269999999999982,0.0,39.69119509000537,2838.38,3088.41,21.325440947086253,-78.67455905291374,-60.11259193314527,-52.83938313429806,0.0142934811203283,43321838925.0,0
2279,2019-05-23,2880.84,2885.14,2846.96,2852.52,197340309.0,-39.17999999999984,39.17999999999984,0.0,34.11004415509797,2838.38,2986.54,9.543736501079838,-90.45626349892017,-61.82725300253924,-54.6369571079463,-0.0294943199022866,43124498616.0,0
2280,2019-05-24,2847.84,2871.86,2846.02,2852.99,167205490.0,0.4699999999997999,0.0,0.4699999999997999,34.23803700036545,2838.38,2956.78,12.33952702702674,-87.66047297297325,-62.42857146998449,-56.19527998035394,-0.017467309063233,43291704106.0,1
2281,2019-05-27,2851.28,2898.13,2833.04,2892.38,196720902.0,39.39000000000033,0.0,39.39000000000033,44.637646875216525,2833.04,2956.78,47.95539033457252,-52.04460966542749,-59.046030993253225,-56.7654301829338,0.0030413266703888,43488425008.0,1
2282,2019-05-28,2890.27,2924.04,2887.08,2909.91,223310557.0,17.529999999999745,0.0,17.529999999999745,48.79572232370845,2833.04,2956.78,62.12219169225776,-37.87780830774224,-54.324598642615456,-56.27726387487014,-0.0097901098452366,43711735565.0,1
2283,2019-05-29,2894.83,2934.98,2890.66,2914.7,198958821.0,4.789999999999964,0.0,4.789999999999964,49.98018507799392,2833.04,2956.78,65.99321157265209,-34.00678842734791,-49.62427872524768,-54.946666844945646,-0.0138748388712018,43910694386.0,1
2284,2019-05-30,2903.42,2907.85,2881.38,2905.81,205758789.0,-8.889999999999873,8.889999999999873,0.0,47.62117691637658,2833.04,2956.78,58.80879262970733,-41.19120737029267,-46.08534683870357,-53.17440284369723,0.0081566804288242,43704935597.0,0
2285,2019-05-31,2904.5,2922.91,2895.58,2898.7,195230580.0,-7.110000000000127,7.110000000000127,0.0,45.6335644021081,2833.04,2956.78,53.06287376757696,-46.93712623242304,-43.35466975564259,-51.2104562260863,0.0097888943078101,43509705017.0,0
2286,2019-06-03,2901.74,2920.83,2875.9,2890.08,215943554.0,-8.61999999999989,8.61999999999989,0.0,43.116136682737405,2833.04,2956.78,46.09665427509282,-53.90334572490718,-41.40881540560167,-49.25012806198938,-0.005468053696356,43293761463.0,0
2287,2019-06-04,2887.64,2888.39,2851.97,2862.28,188463541.0,-27.799999999999727,27.799999999999727,0.0,35.772553815649744,2833.04,2956.78,23.630192338775,-76.36980766122501,-41.63005412957955,-47.726113275507416,-0.0101739461216584,43105297922.0,0
2288,2019-06-05,2882.94,2888.77,2858.57,2861.42,181561047.0,-0.8600000000001273,0.8600000000001273,0.0,35.55638783043693,2833.04,2956.78,22.935186681752104,-77.0648133182479,-41.39757672951009,-46.46040596630796,0.0031200482380491,42923736875.0,0
2289,2019-06-06,2862.33,2862.33,2822.19,2827.8,177064411.0,-33.61999999999989,33.61999999999989,0.0,27.940524664105283,2822.19,2934.98,4.973845199042583,-95.0261548009574,-43.425606382111255,-45.85344604946862,-0.0088293334361493,42746672464.0,0
2290,2019-06-10,2833.01,2861.13,2824.36,2852.13,166585918.0,24.329999999999927,0.0,24.329999999999927,38.87317895044119,2822.19,2934.98,26.544906463339007,-73.455093536661,-42.5787850970305,-45.198513858981,-0.0139158755073676,42913258382.0,1
2291,2019-06-11,2854.07,2927.43,2854.07,2925.72,260525796.0,73.58999999999969,0.0,73.58999999999969,60.03455080016284,2822.19,2934.98,91.79005230960172,-8.20994769039828,-35.559665456616585,-43.27074417850813,0.0054331577265276,43173784178.0,1
2292,2019-06-12,2917.22,2924.7,2903.88,2909.38,240255775.0,-16.33999999999969,16.33999999999969,0.0,55.14365187345158,2822.19,2934.98,77.3029523893963,-22.697047610603704,-30.95859262772683,-40.80831386835187,-0.0018252307270043,42933528403.0,0
2293,2019-06-13,2905.29,2918.42,2885.92,2910.74,212957791.0,1.3599999999996726,0.0,1.3599999999996726,55.49187808211538,2822.19,2934.98,78.50873304370933,-21.491266956290666,-26.89246898540341,-38.02514489176218,0.0016966009477563,43146486194.0,1
2294,2019-06-14,2913.0,2924.32,2879.66,2881.97,215435796.0,-28.769999999999985,28.769999999999985,0.0,46.6518221577425,2822.19,2934.98,53.00115258444876,-46.99884741555123,-25.69533543104308,-35.559182999618365,-0.0057715527650326,42931050398.0,0
2295,2019-06-17,2880.42,2902.48,2877.39,2887.62,153964960.0,5.650000000000091,0.0,5.650000000000091,48.51048609876961,2822.19,2934.98,58.01046192038288,-41.98953807961711,-24.013873695506845,-33.25012113879606,-0.0008511875103803,43085015358.0,1
2296,2019-06-18,2891.09,2898.33,2874.31,2890.16,147705320.0,2.539999999999964,0.0,2.539999999999964,49.42450380951,2822.19,2934.98,60.26243461299745,-39.73756538700255,-22.220205683955555,-31.04413804782796,0.0097404866050838,43232720678.0,1
2297,2019-06-19,2944.12,2953.34,2916.21,2917.8,230756973.0,27.640000000000327,0.0,27.640000000000327,58.64260070737724,2822.19,2953.34,72.90125810141065,-27.09874189858936,-18.356788231213613,-28.50666808450509,0.0197035038547295,43463477651.0,1
2298,2019-06-20,2917.33,2997.39,2915.09,2987.12,291011537.0,69.31999999999971,0.0,69.31999999999971,72.92364009592777,2822.19,2997.39,94.13812785388129,-5.861872146118717,-9.590899477855146,-24.723514363175106,0.0563406181483838,43754489188.0,1
2299,2019-06-21,2990.37,3010.35,2989.25,3001.98,286973835.0,14.860000000000127,0.0,14.860000000000127,75.05428336759977,2822.19,3010.35,95.55165816326536,-4.448341836734639,-1.428326813795593,-20.064476853299205,0.0525396808700864,44041463023.0,1
2300,2019-06-24,3004.29,3012.83,2994.42,3008.15,210493894.0,6.170000000000073,0.0,6.170000000000073,75.96055656215147,2822.19,3012.83,97.54511120436432,-2.454888795635669,5.47532216019772,-14.95651705059982,0.0281742613783957,44251956917.0,1
2301,2019-06-25,3004.91,3004.91,2948.99,2982.07,243699244.0,-26.079999999999927,26.079999999999927,0.0,64.52714291608766,2822.19,3012.83,83.86487620646255,-16.135123793537446,8.741311274748568,-10.21695138553014,0.0249847046449758,44008257673.0,0
2302,2019-06-26,2964.62,2986.91,2958.46,2976.28,174449533.0,-5.789999999999964,5.789999999999964,0.0,62.13151903935404,2822.19,3012.83,80.82773814519526,-19.172261854804734,10.738638230311608,-6.02583346236179,0.0225166108961982,43833808140.0,0
2303,2019-06-27,2982.61,3011.54,2981.04,2996.79,195397049.0,20.509999999999764,0.0,20.509999999999764,67.12074495183025,2824.36,3012.83,91.48936170212768,-8.51063829787233,13.817243244153817,-2.0572181210586686,0.0398408033393824,44029205189.0,1
2304,2019-06-28,2992.24,2992.24,2961.22,2978.88,181431523.0,-17.909999999999854,17.909999999999854,0.0,59.25470804482374,2854.07,3012.83,78.61552028218703,-21.38447971781297,14.643076309196658,1.282840764992398,0.0316038813971368,43847773666.0,0
2305,2019-07-01,3024.62,3045.37,3014.69,3044.9,250840433.0,66.01999999999998,0.0,66.01999999999998,72.8084875742324,2874.31,3045.37,99.72524260493408,-0.2747573950659418,20.389776558911308,5.104227923776182,0.0535402884269384,44098614099.0,1
2306,2019-07-02,3042.58,3048.48,3033.78,3043.94,214520624.0,-0.9600000000000364,0.9600000000000364,0.0,72.40438513442005,2874.31,3048.48,97.39335132341968,-2.6066486765803307,24.5832337168481,9.000029082390567,0.0432312015902391,43884093475.0,0
2307,2019-07-03,3031.83,3031.83,3006.32,3015.26,212296173.0,-28.67999999999984,28.67999999999984,0.0,60.77649467596351,2874.31,3048.48,80.92668082907515,-19.07331917092484,25.30069178968324,12.260161623849104,0.00942044511101,43671797302.0,0
2308,2019-07-04,3015.68,3024.5,2991.91,3005.25,194415133.0,-10.010000000000218,10.010000000000218,0.0,57.08453166252836,2874.31,3048.48,75.17942240339897,-24.820577596601023,24.775957324928186,14.763320764064924,0.0010892810744909,43477382169.0,0
2309,2019-07-05,3004.74,3014.85,2990.92,3011.06,156755429.0,5.809999999999945,0.0,5.809999999999945,58.7622038410597,2874.31,3048.48,78.51524372739274,-21.484756272607257,24.545969270491696,16.71985046535028,0.0009673719728071,43634137598.0,1
2310,2019-07-08,2997.81,2997.81,2918.72,2933.36,211541268.0,-77.69999999999982,77.69999999999982,0.0,36.65228672121998,2915.09,3048.48,13.696678911462628,-86.30332108853737,17.887762455528446,16.953432863385913,-0.0163342912808888,43422596330.0,0
2311,2019-07-09,2928.82,2937.76,2912.81,2928.23,145110604.0,-5.130000000000109,5.130000000000109,0.0,35.630968867237485,2912.81,3048.48,11.365814107761528,-88.63418589223848,12.058138740608229,15.974374038830376,-0.0161443143790235,43277485726.0,0
2312,2019-07-10,2935.19,2936.75,2908.16,2915.3,135483538.0,-12.929999999999836,12.929999999999836,0.0,32.95995851271192,2908.16,3048.48,5.088369441277309,-94.91163055872268,6.321902055236478,14.043879642111596,-0.0271924292326121,43142002188.0,0
2313,2019-07-11,2928.06,2945.8,2907.89,2917.76,143692522.0,2.4600000000000364,0.0,2.4600000000000364,34.04532894795284,2907.89,3048.48,7.020413969699364,-92.97958603030064,1.9518943723355733,11.625482588156393,-0.0205177784939305,43285694710.0,1
2314,2019-07-12,2915.34,2938.53,2905.81,2930.55,137794759.0,12.789999999999964,0.0,12.789999999999964,39.88403829402876,2905.81,3048.48,17.340716338403464,-82.65928366159653,-0.473859731047014,9.20561412431571,-0.0375545994942362,43423489469.0,1
2315,2019-07-15,2921.55,2955.0,2886.7,2942.19,167643397.0,11.639999999999873,0.0,11.639999999999873,44.99716672619216,2886.7,3048.48,34.2996662133763,-65.70033378662372,-1.4404322082714316,7.076404857798281,-0.0334270714928678,43591132866.0,1
2316,2019-07-16,2938.64,2944.82,2931.29,2937.62,131811751.0,-4.570000000000164,4.570000000000164,0.0,43.32771518745768,2886.7,3048.48,31.474842378538764,-68.52515762146125,-2.5458615598486176,5.151951574268901,-0.0257490233014733,43459321115.0,0
2317,2019-07-17,2933.02,2942.07,2924.46,2931.69,149631616.0,-5.929999999999836,5.929999999999836,0.0,41.04757000743261,2886.7,3048.48,27.80937075040189,-72.1906292495981,-3.855974452852479,3.350366368844625,-0.0244771649613176,43309689499.0,0
2318,2019-07-18,2921.74,2921.74,2901.18,2901.18,149888828.0,-30.51000000000022,30.51000000000022,0.0,31.276360187298597,2886.7,3048.48,8.950426505130423,-91.04957349486958,-7.2723196031788575,1.2258291744399277,-0.0364921323387777,43159800671.0,0
2319,2019-07-19,2909.68,2939.6,2909.68,2924.2,149469553.0,23.019999999999985,0.0,23.019999999999985,43.07371740204764,2886.7,3048.48,23.179626653480007,-76.82037334652,-8.029714583028635,-0.6252795770537856,-0.0031226988845557,43309270224.0,1
2320,2019-07-22,2925.79,2927.16,2879.69,2886.97,180674960.0,-37.23000000000002,37.23000000000002,0.0,32.62314594019564,2879.69,3031.83,4.785066386223051,-95.21493361377696,-11.501523019286196,-2.8005282655002683,-0.0140904232249516,43128595264.0,0
2321,2019-07-23,2886.9,2901.36,2883.05,2899.94,129310508.0,12.970000000000256,0.0,12.970000000000256,38.61026996922621,2879.69,3024.5,13.983840894965825,-86.01615910503418,-13.05588549191816,-4.851599710783848,-0.0052687545021096,43257905772.0,1
2322,2019-07-24,2907.93,2936.45,2907.79,2923.28,155245762.0,23.340000000000146,0.0,23.340000000000146,48.17282309914087,2879.69,3014.85,32.25066587747868,-67.7493341225213,-12.26302548623744,-6.333884865874567,0.0018918622504935,43413151534.0,1
2323,2019-07-25,2923.19,2937.36,2916.15,2937.36,145684385.0,14.079999999999927,0.0,14.079999999999927,53.24248786874668,2879.69,2997.81,48.8232306129361,-51.17676938706389,-10.378898410718648,-7.142887574843385,0.0023237958744946,43558835919.0,1
2324,2019-07-26,2928.06,2948.33,2924.45,2944.54,139343388.0,7.179999999999836,0.0,7.179999999999836,55.787204130330565,2879.69,2955.0,86.11074226530336,-13.889257734696644,-8.211688896728901,-7.356647839220488,0.0007987247594478,43698179307.0,1
2325,2019-07-29,2943.92,2948.47,2932.98,2941.01,127991846.0,-3.5299999999997453,3.5299999999997453,0.0,54.11643920073068,2879.69,2955.0,81.42344974107051,-18.57655025892948,-6.701747666147185,-7.225667804605828,0.0011539954112513,43570187461.0,0
2326,2019-07-30,2946.26,2965.63,2946.26,2952.34,148316462.0,11.329999999999927,0.0,11.329999999999927,58.69744444808816,2879.69,2965.63,84.53572259716087,-15.46427740283914,-4.538554420921173,-6.688245127868897,0.0070437188106518,43718503923.0,1
2327,2019-07-31,2944.4,2944.4,2926.49,2932.51,141052348.0,-19.829999999999927,19.829999999999927,0.0,48.84838806926955,2879.69,2965.63,61.46148475680723,-38.53851524319277,-4.373903822285683,-6.225376866752255,0.0107990541779552,43577451575.0,0
2328,2019-08-01,2920.85,2927.34,2901.75,2908.77,142389813.0,-23.74000000000024,23.74000000000024,0.0,39.65665478608046,2879.69,2965.63,33.837561089131846,-66.16243891086815,-6.088848181504545,-6.198071129702713,-0.0052766568634156,43435061762.0,0
2329,2019-08-02,2861.33,2872.47,2851.44,2867.84,184888443.0,-40.92999999999984,40.92999999999984,0.0,28.855237093360717,2851.44,2965.63,14.362028198616414,-85.63797180138359,-10.62814819876803,-7.084086543515777,-0.0066263244855331,43250173319.0,0
2330,2019-08-05,2854.58,2863.69,2821.5,2821.5,167419423.0,-46.34000000000015,46.34000000000015,0.0,21.282543237133027,2821.5,2965.63,0.0,-100.0,-17.7600995148714,-9.219289137786902,-0.0270488354931481,43082753896.0,0
2331,2019-08-06,2776.99,2787.42,2733.92,2777.56,231123727.0,-43.940000000000055,43.940000000000055,0.0,16.534889986704485,2733.92,2965.63,18.833887186569363,-81.16611281343063,-26.6506015486857,-12.705551619966664,-0.0498481158151118,42851630169.0,0
2332,2019-08-07,2789.02,2792.69,2768.68,2768.68,157716752.0,-8.88000000000011,8.88000000000011,0.0,15.71730238583541,2733.92,2965.63,15.001510508825582,-84.99848949117442,-34.02076010453857,-16.968593316881048,-0.0574257156085737,42693913417.0,0
2333,2019-08-08,2784.18,2799.69,2782.24,2794.55,149539564.0,25.870000000000346,0.0,25.870000000000346,27.729569910076705,2733.92,2965.63,26.166328600405723,-73.83367139959428,-37.34369617987022,-21.043613889478884,-0.0509383469064776,42843452981.0,1
2334,2019-08-09,2805.59,2808.33,2770.48,2774.75,148240293.0,-19.800000000000185,19.800000000000185,0.0,24.62958023903585,2733.92,2965.63,17.621164386517595,-82.37883561348241,-41.10105411718223,-25.05510193501956,-0.0565315996885424,42695212688.0,0
2335,2019-08-12,2781.98,2814.99,2776.62,2814.99,131563433.0,40.23999999999978,0.0,40.23999999999978,40.28432946266818,2733.92,2965.63,34.98770014241927,-65.01229985758073,-40.36643649978123,-28.117368847971896,-0.0465224195045287,42826776121.0,1
2336,2019-08-13,2798.05,2802.04,2790.61,2797.26,130916505.0,-17.729999999999563,17.729999999999563,0.0,36.43678296471614,2733.92,2965.63,27.33589400543789,-72.6641059945621,-40.74522399042371,-30.642939876462265,-0.0461208998434787,42695859616.0,0
2337,2019-08-14,2824.49,2829.89,2807.72,2808.91,144014641.0,11.649999999999636,0.0,11.649999999999636,40.72875500461836,2733.92,2965.63,32.3637305252254,-67.63626947477461,-39.64831705015331,-32.444015311200474,-0.034330662101163,42839874257.0,1
2338,2019-08-15,2762.34,2815.9,2756.83,2815.8,152772152.0,6.890000000000327,0.0,6.890000000000327,43.33954693015676,2733.92,2965.63,35.3372750420785,-64.6627249579215,-37.78745472315904,-33.51270319359219,-0.0181460611470654,42992646409.0,1
2339,2019-08-16,2817.57,2840.32,2811.8,2823.82,148582344.0,8.019999999999982,0.0,8.019999999999982,46.50437092891178,2733.92,2965.63,38.79849812265335,-61.20150187734665,-35.25911580915317,-33.86198571670438,0.000822257664363,43141228753.0,1
2340,2019-08-19,2835.52,2883.1,2829.85,2883.1,214546668.0,59.27999999999975,0.0,59.27999999999975,63.76561647397409,2733.92,2944.4,70.87609274040281,-29.123907259597196,-28.14752132314652,-32.71909283799281,0.0379973789945131,43355775421.0,1
2341,2019-08-20,2879.08,2892.08,2875.0,2880.0,189677206.0,-3.099999999999909,3.099999999999909,0.0,62.54784007129487,2733.92,2927.34,75.52476476062449,-24.47523523937552,-22.502283234985956,-30.67573091739144,0.0402068855916899,43166098215.0,0
2342,2019-08-21,2875.47,2885.59,2872.56,2880.33,159019665.0,0.3299999999999272,0.0,0.3299999999999272,62.63548775870693,2733.92,2892.08,92.5708143651998,-7.429185634800209,-17.796614838450296,-28.09990770160321,0.0306954608076432,43325117880.0,1
2343,2019-08-22,2887.66,2888.5,2867.55,2883.44,149206215.0,3.1100000000001278,0.0,3.1100000000001278,63.56275200992617,2733.92,2892.08,94.53717754172996,-5.462822458270031,-13.658936011097012,-25.21171336350197,0.0391710964951796,43474324095.0,1
2344,2019-08-23,2885.15,2902.46,2878.74,2897.43,159156826.0,13.989999999999782,0.0,13.989999999999782,67.72065324326353,2733.92,2902.46,97.01554527115212,-2.9844547288478704,-9.145496063613336,-21.99846990352425,0.0292860720641991,43633480921.0,1
2345,2019-08-26,2851.02,2870.49,2849.24,2863.57,169895363.0,-33.85999999999967,33.85999999999967,0.0,51.355139024829725,2756.83,2902.46,73.29533749914177,-26.704662500858237,-8.20618560830735,-19.240013044480868,0.0237053402257922,43463585558.0,0
2346,2019-08-27,2879.52,2919.64,2879.41,2902.19,208141794.0,38.61999999999989,0.0,38.61999999999989,63.09303122878942,2756.83,2919.64,89.28198513604826,-10.718014863951735,-4.295943107902076,-16.25119905716511,0.0332086111694571,43671727352.0,1
2347,2019-08-28,2901.63,2905.44,2887.01,2893.76,183097903.0,-8.429999999999836,8.429999999999836,0.0,59.47830864534813,2756.83,2919.64,84.10417050549741,-15.895829494502587,-1.8558848171805948,-13.372136209168206,0.027686625470559,43488629449.0,0
2348,2019-08-29,2896.0,2898.6,2878.59,2890.92,178613082.0,-2.840000000000145,2.840000000000145,0.0,58.18254740893269,2756.83,2919.64,82.35980590872808,-17.64019409127192,-0.149561258157064,-10.727621218965975,0.0237621378133165,43310016367.0,0
2349,2019-08-30,2907.38,2914.58,2874.1,2886.24,193959951.0,-4.680000000000291,4.680000000000291,0.0,55.86831297854564,2756.83,2919.64,79.48528960137577,-20.514710398624224,0.8156729975803501,-8.418962375656712,0.0010891054767436,43116056416.0,0
2350,2019-09-02,2886.94,2928.48,2883.68,2924.11,202786807.0,37.870000000000346,0.0,37.870000000000346,67.81937402958037,2756.83,2928.48,97.45412175939418,-2.545878240605819,4.583583904525312,-5.818453119620306,0.0153159722222222,43318843223.0,1
2351,2019-09-03,2925.94,2930.15,2915.2,2930.15,189001216.0,6.039999999999964,0.0,6.039999999999964,69.34700478417679,2756.83,2930.15,100.0,-0.0,7.9652396418237,-3.0617145673315047,0.0172966292056813,43507844439.0,1
2352,2019-09-04,2927.75,2957.41,2925.88,2957.41,225495907.0,27.259999999999764,0.0,27.259999999999764,75.42268784296718,2811.8,2957.41,100.0,-0.0,12.698499952904967,0.0903283367157904,0.0256533862331103,43733340346.0,1
2353,2019-09-05,2972.66,3015.84,2972.66,2985.86,305438706.0,28.450000000000276,0.0,28.450000000000276,80.1585576839685,2829.85,3015.84,83.8808538093446,-16.1191461906554,18.531698202864845,3.778602309945603,0.0305201506162358,44038779052.0,1
2354,2019-09-06,2996.62,2999.94,2981.6,2999.6,216826035.0,13.739999999999782,0.0,13.739999999999782,82.0825124313566,2849.24,3015.84,90.252100840336,-9.747899159663987,23.9867487040824,7.820231588772964,0.0475036405605588,44255605087.0,1
2355,2019-09-09,3023.78,3026.24,3005.69,3024.74,243377752.0,25.139999999999876,0.0,25.139999999999876,85.12718874202461,2849.24,3026.24,99.15254237288136,-0.847457627118644,29.99276549330898,12.25473836968017,0.0422267322263532,44498982839.0,1
2356,2019-09-10,3027.41,3027.41,3005.38,3021.2,240012947.0,-3.539999999999964,3.539999999999964,0.0,82.84006151227504,2849.24,3027.41,96.51456474153896,-3.485435258461039,34.07414314306425,16.61861932435699,0.044039588632091,44258969892.0,0
2357,2019-09-11,3029.93,3030.56,3004.22,3008.81,229837362.0,-12.389999999999873,12.389999999999873,0.0,74.73153590995675,2849.24,3030.56,88.00463269358042,-11.995367306419578,35.89511830292349,20.47391912007029,0.0407794058638772,44029132530.0,0
2358,2019-09-12,3016.63,3033.47,3005.19,3031.24,196968701.0,22.42999999999984,0.0,22.42999999999984,79.02091061946652,2849.24,3033.47,98.78955653259511,-1.2104434674048845,38.7020348150304,24.11954225906232,0.0502383724153223,44226101231.0,1
2359,2019-09-16,3041.92,3042.93,3020.05,3030.75,221878959.0,-0.4899999999997817,0.4899999999997817,0.0,78.6842304346552,2874.1,3042.93,92.78564236213953,-7.214357637860476,40.42104877961583,27.379843563173026,0.0364692162743536,44004222272.0,0
2360,2019-09-17,3023.71,3023.71,2970.57,2978.12,223338061.0,-52.63000000000011,52.63000000000011,0.0,51.4938170956056,2874.1,3042.93,61.61227270034948,-38.38772729965052,37.10881130138887,29.325637110816192,0.0163711755370885,43780884211.0,0
2361,2019-09-18,2984.08,2996.4,2982.4,2985.66,168046699.0,7.539999999999964,0.0,7.539999999999964,54.11492806253207,2874.1,3042.93,66.07830361902505,-33.92169638097495,34.69234249307556,30.398978187268067,0.0095522771614351,43948930910.0,1
2362,2019-09-19,2992.92,2999.28,2975.4,2999.28,162690615.0,13.620000000000346,0.0,13.620000000000346,58.75969420601879,2874.1,3042.93,74.14559023870186,-25.854409761298143,33.49023909632797,31.01723036908005,0.0044945174924477,44111621525.0,1
2363,2019-09-20,3004.81,3011.34,2996.19,3006.45,182145302.0,7.169999999999618,0.0,7.169999999999618,61.148548388113305,2883.68,3042.93,77.09262166405023,-22.907378335949776,32.73873086131107,31.361530467526254,0.0022836378183757,44293766827.0,1
2364,2019-09-23,2998.4,2998.4,2960.83,2977.08,168139450.0,-29.36999999999989,29.36999999999989,0.0,48.00561042511039,2915.2,3042.93,48.44594065607148,-51.55405934392852,29.433945425200363,30.976013459061083,-0.0157567261979542,44125627377.0,0
2365,2019-09-24,2979.48,3002.9,2973.76,2985.34,163902761.0,8.260000000000218,0.0,8.260000000000218,51.39565499984023,2925.88,3042.93,50.79880392994461,-49.20119607005538,27.16821386784568,30.214453540818003,-0.0118694558453593,44289530138.0,1
2366,2019-09-25,2977.67,2977.67,2955.43,2955.43,168543135.0,-29.91000000000031,29.91000000000031,0.0,40.39216747066632,2955.43,3042.93,0.0,-100.0,22.69747587997153,28.71105800864871,-0.017741233245037,44120987003.0,0
2367,2019-09-26,2964.48,2970.04,2928.26,2929.09,188932541.0,-26.33999999999969,26.33999999999969,0.0,33.17506328586241,2928.26,3042.93,0.7238161681345863,-99.2761838318654,16.834903657221275,26.335827138363225,-0.0336990802443882,43932054462.0,0
2368,2019-09-27,2929.49,2939.08,2920.93,2932.17,132905777.0,3.0799999999999272,0.0,3.0799999999999272,34.74811051122566,2920.93,3042.93,9.213114754098555,-90.78688524590144,12.295567543588731,23.52777521940833,-0.0325266023261568,44064960239.0,1
2369,2019-09-30,2927.92,2936.48,2905.19,2905.19,116646811.0,-26.980000000000015,26.980000000000015,0.0,28.06961303726149,2905.19,3042.93,0.0,-100.0,6.446736485402653,20.111567472607195,-0.0244886035485473,43948313428.0,0
2370,2019-10-08,2905.76,2933.02,2905.76,2913.57,125535812.0,8.38000000000011,0.0,8.38000000000011,32.70494362728162,2905.19,3042.93,6.0839262378394965,-93.91607376216052,2.4593419357079256,16.58112236522734,-0.0241454150841019,44073849240.0,1
2371,2019-10-09,2902.08,2924.86,2891.54,2924.86,130424144.0,11.289999999999964,0.0,11.289999999999964,38.83249438189512,2891.54,3042.93,22.009379747671705,-77.9906202523283,0.2079149587598294,13.306480883933837,-0.0248126216958737,44204273384.0,1
2372,2019-10-10,2923.71,2949.24,2918.23,2947.71,134239752.0,22.84999999999991,0.0,22.84999999999991,49.558375721988256,2891.54,3042.93,37.10284695158209,-62.89715304841791,0.264399065609723,10.698064520269016,-0.019537993314374,44338513136.0,1
2373,2019-10-11,2954.82,2980.79,2943.01,2973.66,161203746.0,25.949999999999815,0.0,25.949999999999815,58.98319639018328,2891.54,3023.71,62.1321025951425,-37.8678974048575,2.375725370797681,9.033596690374749,-0.0011487766536337,44499716882.0,1
2374,2019-10-14,2993.96,3026.38,2989.81,3007.88,208614802.0,34.220000000000255,0.0,34.220000000000255,68.06287376462562,2891.54,3026.38,86.28003559774548,-13.719964402254508,6.732625178329727,8.573402387965745,0.0075502287846609,44708331684.0,1
2375,2019-10-15,3005.66,3005.66,2986.3,2991.05,155376904.0,-16.829999999999927,16.829999999999927,0.0,60.46697972471132,2891.54,3026.38,73.79857609018103,-26.20142390981896,8.726861492739317,8.60409420892046,0.0120523916993466,44552954780.0,0
2376,2019-10-16,2992.61,3010.42,2975.92,2978.71,149885496.0,-12.340000000000146,12.340000000000146,0.0,55.25043134780428,2891.54,3026.38,64.64698902402847,-35.353010975971536,9.205458474197258,8.72436706197582,0.0169404149411591,44403069284.0,0
2377,2019-10-17,2979.99,2986.72,2969.57,2977.33,122527614.0,-1.3800000000001091,1.3800000000001091,0.0,54.64214989497805,2891.54,3026.38,63.62355384158994,-36.37644615841006,9.365436639451218,8.852580977470899,0.0154015626651933,44280541670.0,0
2378,2019-10-18,2982.34,2987.2,2933.24,2938.14,149990678.0,-39.190000000000055,39.190000000000055,0.0,40.15574368807207,2891.54,3026.38,34.55947789973291,-65.44052210026709,6.257779228873005,8.33362062775132,0.0113417711061927,44130550992.0,0
2379,2019-10-21,2933.9,2940.32,2917.69,2939.62,132475107.0,1.4800000000000182,0.0,1.4800000000000182,40.839185249575614,2891.54,3026.38,35.65707505191328,-64.3429249480867,3.869753859002685,7.440847274001592,0.0089409212752737,44263026099.0,1
2380,2019-10-22,2945.6,2954.64,2934.39,2954.38,117482048.0,14.760000000000218,0.0,14.760000000000218,47.71086508819454,2891.54,3026.38,46.60338178582029,-53.39661821417971,3.132129949742648,6.579103809149803,0.0100927907660537,44380508147.0,1
2381,2019-10-23,2952.97,2957.3,2934.63,2941.62,123812881.0,-12.760000000000218,12.760000000000218,0.0,42.75695865091558,2891.54,3026.38,37.14031444675161,-62.85968555324839,1.5006339530314108,5.563409837926125,-0.0020660105641329,44256695266.0,0
2382,2019-10-24,2944.01,2953.04,2927.06,2940.92,126540290.0,-0.6999999999998181,0.6999999999998181,0.0,42.47777655891095,2891.54,3026.38,36.62118065855833,-63.37881934144167,0.1494546513004024,4.480618800600981,-0.011010001143372,44130154976.0,0
2383,2019-10-25,2940.47,2958.24,2920.52,2954.93,136860706.0,14.009999999999764,0.0,14.009999999999764,50.01495565860985,2891.54,3026.38,47.01127261940062,-52.98872738059938,0.2067420399575894,3.625843448472303,-0.0176037607883293,44267015682.0,1
2384,2019-10-28,2958.69,2980.13,2956.96,2980.05,173731481.0,25.120000000000346,0.0,25.120000000000346,60.675237469874965,2891.54,3026.38,65.64075941857025,-34.35924058142975,2.253143930900478,3.3513035449579376,-0.0036776382875578,44440747163.0,1
2385,2019-10-29,2979.04,2979.04,2954.18,2954.18,166110058.0,-25.870000000000346,25.870000000000346,0.0,48.40746653304418,2917.69,3026.38,33.57254577237995,-66.42745422762005,1.767069698096293,3.0344567755856087,-0.0082351084865597,44274637105.0,0
2386,2019-10-30,2949.46,2953.3,2934.83,2939.32,158798110.0,-14.859999999999673,14.859999999999673,0.0,42.68713187979617,2917.69,3026.38,19.90063483301141,-80.09936516698859,0.1806916558925877,2.463703751647005,-0.0127664719732107,44115838995.0,0
2387,2019-10-31,2944.84,2946.75,2923.52,2929.06,161571483.0,-10.260000000000218,10.260000000000218,0.0,39.01423576255144,2917.69,3026.38,10.460943969086289,-89.53905603091371,-1.882717826242697,1.5944194360690644,-0.0030903905191719,43954267512.0,0
2388,2019-11-01,2924.34,2959.83,2917.15,2958.2,159907373.0,29.139999999999876,0.0,29.139999999999876,52.42806033014329,2917.15,3010.42,44.01200814838612,-55.98799185161389,-1.1533353085283125,1.044868487149589,0.0063205448323251,44114174885.0,1
2389,2019-11-04,2964.58,2983.06,2964.58,2975.49,167248364.0,17.289999999999964,0.0,17.289999999999964,58.65407596033645,2917.15,3010.42,62.549587219898896,-37.4504127801011,0.8105209125701549,0.9979989722337022,0.0071453232150229,44281423249.0,1
2390,2019-11-05,2977.7,3008.31,2968.03,2991.56,179891593.0,16.070000000000164,0.0,16.070000000000164,63.742938713569984,2917.15,3008.31,81.62571303203157,-18.37428696796844,3.621855320410305,1.522770241869023,0.0169770398623887,44461314842.0,1
2391,2019-11-06,2992.04,2995.56,2969.72,2978.6,165263547.0,-12.960000000000036,12.960000000000036,0.0,57.19258444049417,2917.15,3008.31,67.40895129442728,-32.59104870557271,4.749346889852859,2.1680855714657907,0.0128123172340628,44296051295.0,0
2392,2019-11-07,2978.15,2988.96,2969.12,2978.71,136952678.0,0.1100000000001273,0.0,0.1100000000001273,57.235622279316296,2917.15,3008.31,67.52961825362006,-32.47038174637994,5.587360548078777,2.851940566788388,0.008047567962693,44433003973.0,1
2393,2019-11-08,2993.98,2998.76,2962.84,2964.18,149742107.0,-14.5300000000002,14.5300000000002,0.0,49.630580004153465,2917.15,3008.31,51.5906099166299,-48.4093900833701,5.021162011952583,3.285784855821228,-0.0053254140031209,44283261866.0,0
2394,2019-11-11,2949.96,2949.96,2906.77,2909.97,157916105.0,-54.21000000000004,54.21000000000004,0.0,31.57159211566736,2906.77,3008.31,3.1514674020088824,-96.84853259799112,0.1958935063039462,2.667806585917772,-0.0149652356999234,44125345761.0,0
2395,2019-11-12,2913.0,2918.3,2891.51,2914.82,129729154.0,4.850000000000364,0.0,4.850000000000364,34.048879949556806,2891.51,3008.31,19.95719178082192,-80.04280821917808,-3.199925334375166,1.4942602018591844,-0.0083352612168801,44255074915.0,1
2396,2019-11-13,2913.02,2913.86,2893.97,2905.24,129765841.0,-9.580000000000382,9.580000000000382,0.0,31.453611815788065,2891.51,3008.31,11.755136986301023,-88.24486301369897,-6.588217299758071,-0.122235298464267,-0.0081323018306215,44125309074.0,0
2397,2019-11-14,2907.74,2917.37,2899.62,2909.87,129145448.0,4.630000000000109,0.0,4.630000000000109,34.248401355961434,2891.51,3008.31,15.719178082191537,-84.28082191780847,-8.798437873208968,-1.857475813413208,-0.0163376377526873,44254454522.0,1
2398,2019-11-15,2911.35,2917.83,2891.2,2891.34,135519463.0,-18.529999999999745,18.529999999999745,0.0,28.82179948102652,2891.2,3008.31,0.1195457262405663,-99.88045427375944,-11.908001708554366,-3.86758099244144,-0.028281056229394,44118935059.0,0
2399,2019-11-18,2889.55,2911.38,2884.09,2909.2,124433177.0,17.859999999999673,0.0,17.859999999999673,39.485356120609325,2884.09,3008.31,20.214136209949856,-79.78586379005014,-12.783836602815429,-5.650832114516239,-0.0275307866130046,44243368236.0,1
2400,2019-11-19,2904.28,2933.99,2902.85,2933.99,135417604.0,24.789999999999964,0.0,24.789999999999964,51.19540630583843,2884.09,3008.31,40.1706649492833,-59.8293350507167,-11.346797427631827,-6.790025177139358,-0.0149768347545827,44378785840.0,1
2401,2019-11-20,2928.11,2930.49,2907.42,2911.05,137357530.0,-22.9399999999996,22.9399999999996,0.0,42.42892859052305,2884.09,3008.31,21.70342939945265,-78.29657060054735,-11.921575311147537,-7.816335203940994,-0.022714530786817,44241428310.0,0
2402,2019-11-21,2902.55,2910.36,2891.53,2903.64,123458607.0,-7.410000000000309,7.410000000000309,0.0,39.88350448754166,2884.09,3008.31,15.738206407985636,-84.26179359201437,-12.827152566766472,-8.81849867650609,-0.0204238608991356,44117969703.0,0
2403,2019-11-22,2906.24,2925.02,2873.99,2885.29,158623365.0,-18.34999999999991,18.34999999999991,0.0,34.047116084286486,2873.99,3008.31,8.41274568195367,-91.58725431804632,-14.854289703598624,-10.025656881924595,-0.0084811870912757,43959346338.0,0
2404,2019-11-25,2885.61,2906.61,2880.65,2906.17,178587429.0,20.88000000000011,0.0,20.88000000000011,44.67639243482593,2873.99,2998.76,25.791456279554524,-74.20854372044548,-14.60758187970805,-10.94204188148129,-0.0029675931961493,44137933767.0,1
2405,2019-11-26,2912.52,2915.04,2897.93,2907.06,170004663.0,0.8899999999998727,0.0,0.8899999999998727,45.11146228449415,2873.99,2998.76,26.5047687745452,-73.49523122545479,-14.1768269535296,-11.588998895890953,0.0006264542688383,44307938430.0,1
2406,2019-11-27,2905.4,2914.49,2893.42,2903.19,133862205.0,-3.869999999999891,3.869999999999891,0.0,43.39909078097296,2873.99,2998.76,23.403061633405603,-76.5969383665944,-13.986499567452483,-12.06849903020326,-0.0022956352001979,44174076225.0,0
2407,2019-11-28,2902.36,2909.84,2883.43,2889.69,119522468.0,-13.5,13.5,0.0,37.64715579662029,2873.99,2949.96,20.66605238910125,-79.33394761089875,-14.754915437990348,-12.60578231176068,-0.0005706696549004,44054553757.0,0
2408,2019-11-29,2885.97,2892.39,2858.58,2871.98,122612968.0,-17.710000000000036,17.710000000000036,0.0,31.35652780760388,2858.58,2933.99,17.769526587985833,-82.23047341201418,-16.6015670124807,-13.404939251904686,-0.0127938952289288,43931940789.0,0
2409,2019-12-02,2874.45,2888.89,2870.24,2875.81,128755806.0,3.8299999999999272,0.0,3.8299999999999272,34.10409534035763,2858.58,2933.99,22.8484285903727,-77.15157140962731,-17.5536550892175,-14.234682419367248,-0.0198296517711374,44060696595.0,1
2410,2019-12-03,2869.88,2884.86,2857.32,2884.7,123778742.0,8.889999999999873,0.0,8.889999999999873,40.4842596937937,2857.32,2933.99,35.71149080474735,-64.28850919525266,-17.39037759846542,-14.865821455186884,-0.0090517167345117,44184475337.0,1
2411,2019-12-04,2876.91,2882.5,2869.42,2878.12,125543653.0,-6.579999999999927,6.579999999999927,0.0,37.39234052868801,2857.32,2933.99,27.12925524977153,-72.87074475022847,-17.58917298208189,-15.410491760565886,-0.0087889683294072,44058931684.0,0
2412,2019-12-05,2886.52,2902.0,2885.08,2899.47,143163096.0,21.34999999999991,0.0,21.34999999999991,51.31337456900939,2857.32,2933.99,54.97587061432092,-45.02412938567908,-15.841344032127836,-15.49666221487828,0.0049145839759607,44202094780.0,1
2413,2019-12-06,2902.28,2912.01,2894.75,2912.01,134128878.0,12.540000000000418,0.0,12.540000000000418,57.6892817837459,2857.32,2933.99,71.33168123125124,-28.66831876874876,-13.291092358721016,-15.055548243646829,0.002009517681347,44336223658.0,1
2414,2019-12-09,2914.46,2919.59,2905.25,2914.48,160796527.0,2.4699999999998,0.0,2.4699999999998,58.91218663398603,2857.32,2930.49,78.11944786114549,-21.88055213885451,-10.944529453815449,-14.233344485680552,0.0025524068990663,44497020185.0,1
2415,2019-12-10,2908.94,2919.2,2902.79,2917.32,170123998.0,2.840000000000145,0.0,2.840000000000145,60.42952630538514,2857.32,2925.02,88.62629246676538,-11.37370753323462,-8.754777554487191,-13.13763109944188,0.0048670600270737,44667144183.0,1
2416,2019-12-11,2922.6,2928.26,2915.0,2924.42,165541087.0,7.099999999999909,0.0,7.099999999999909,64.2390188229522,2857.32,2928.26,94.58697490837308,-5.4130250916269285,-6.373008658380968,-11.7847066112297,0.0120185902294018,44832685270.0,1
2417,2019-12-12,2926.34,2926.34,2913.48,2915.7,151760804.0,-8.720000000000255,8.720000000000255,0.0,56.527159772407664,2857.32,2928.26,82.29489709613703,-17.70510290386297,-5.129936062760407,-10.453752501535842,0.0152229472350085,44680924466.0,0
2418,2019-12-13,2937.78,2969.98,2935.85,2967.68,211978585.0,51.98000000000002,0.0,51.98000000000002,76.18853762865362,2857.32,2969.98,97.9584590804188,-2.0415409195812044,0.0489947293954173,-8.35320305534959,0.0319457822317885,44892903051.0,1
2419,2019-12-16,2970.97,2984.64,2958.71,2984.39,211862119.0,16.710000000000036,0.0,16.710000000000036,79.60925443664382,2857.32,2984.64,99.80364436066604,-0.1963556393339621,5.4389946978431,-5.594763504711051,0.034558186293202,45104765170.0,1
2420,2019-12-17,2985.26,3039.38,2982.5,3022.42,293032254.0,38.0300000000002,0.0,38.0300000000002,85.19459003618039,2857.32,3039.38,90.68438976161704,-9.315610238382972,12.633678494230026,-1.949075104922835,0.0501368949175156,45397797424.0,1
2421,2019-12-18,3021.47,3033.23,3011.72,3017.04,244089691.0,-5.380000000000109,5.380000000000109,0.0,81.54843078551337,2857.32,3039.38,87.72932000439407,-12.270679995605928,17.69739168519709,1.980218253101151,0.040548789951267,45153707733.0,0
2422,2019-12-19,3017.15,3021.42,3007.99,3017.07,208624264.0,0.0300000000002,0.0,0.0300000000002,81.5535103237592,2857.32,3039.38,87.74579808854227,-12.254201911457734,21.46540182985609,5.8772549684521405,0.0360781728084724,45362331997.0,1
2423,2019-12-20,3019.64,3027.48,3002.26,3004.94,215075755.0,-12.13000000000011,12.13000000000011,0.0,72.27143555834543,2857.32,3039.38,81.08315939800063,-18.916840601999372,23.20529123857841,9.342862222477397,0.0310381268699733,45147256242.0,0
2424,2019-12-23,2999.04,3009.34,2960.44,2962.75,205716617.0,-42.190000000000055,42.190000000000055,0.0,49.61068615801261,2869.42,3039.38,54.91292068722047,-45.08707931277953,20.938420647252315,11.66197390743238,0.0155725117573664,44941539625.0,0
2425,2019-12-24,2965.83,2983.82,2960.68,2982.68,163030250.0,19.92999999999984,0.0,19.92999999999984,56.965476040762695,2885.08,3039.38,63.2534024627348,-36.7465975372652,20.51362550422118,13.432304226790142,0.019921899043229,45104569875.0,1
2426,2019-12-25,2980.43,2988.29,2970.66,2981.88,175654028.0,-0.7999999999997272,0.7999999999997272,0.0,56.58296137239861,2894.75,3039.38,60.2433796584388,-39.7566203415612,19.8832176228816,14.722486906008436,0.0226978084165039,44928915847.0,0
2427,2019-12-26,2981.25,3007.35,2980.4,3007.35,182440426.0,25.4699999999998,0.0,25.4699999999998,65.17370092738349,2902.79,3039.38,76.55025990189607,-23.44974009810393,21.19451381131512,16.016892287069773,0.0133673441880526,45111356273.0,1
2428,2019-12-27,3006.85,3036.11,3003.63,3005.04,247102779.0,-2.309999999999945,2.309999999999945,0.0,63.85157473518097,2902.79,3039.38,74.85906728164572,-25.14093271835428,21.79607619471653,17.172729068599125,0.0069193369499294,44864253494.0,0
2429,2019-12-30,2998.17,3041.4,2983.34,3040.02,248066530.0,34.98000000000002,0.0,34.98000000000002,73.31138288537899,2913.48,3041.4,98.92120075046896,-1.0787992495310417,24.80942477208555,18.70006820929641,0.0058231483380866,45112320024.0,1
2430,2019-12-31,3036.39,3051.68,3030.51,3050.12,217429022.0,10.099999999999907,0.0,10.099999999999907,75.45163526519721,2913.48,3051.68,98.87120115774243,-1.1287988422575597,27.69327992789158,20.49871055301545,0.0109643889375017,45329749046.0,1
2431,2020-01-02,3066.34,3098.1,3066.34,3085.2,292470208.0,35.07999999999993,0.0,35.07999999999993,81.4222406468298,2935.85,3098.1,92.04930662557776,-7.950693374422244,32.435522230271545,22.886072888466668,0.0225815112012646,45622219254.0,1
2432,2020-01-03,3089.02,3093.82,3074.52,3083.79,261496667.0,-1.4099999999998545,1.4099999999998545,0.0,80.51405437658482,2958.71,3098.1,89.73384030418255,-10.26615969581746,35.668840020109656,25.44262631479527,0.0262401245948338,45360722587.0,0
2433,2020-01-06,3070.91,3107.2,3065.31,3083.41,312575842.0,-0.3800000000001091,0.3800000000001091,0.0,80.23575501062084,2960.44,3107.2,83.78986099754701,-16.210139002452987,37.7652703110648,27.90715511404918,0.0407256771580457,45048146745.0,0
2434,2020-01-07,3085.49,3105.45,3084.33,3104.8,276583111.0,21.390000000000327,0.0,21.390000000000327,83.85932945459209,2960.44,3107.2,98.36467702371245,-1.6353229762875714,40.68372401125953,30.46246889349125,0.0409430445103062,45324729856.0,1
2435,2020-01-08,3094.24,3094.24,3059.13,3066.89,297872553.0,-37.91000000000031,37.91000000000031,0.0,60.99179734123837,2960.44,3107.2,72.53338784409921,-27.4666121559008,39.48247008393264,32.266469131579534,0.0285088601821668,45026857303.0,0
2436,2020-01-09,3082.64,3097.33,3080.13,3094.88,243435649.0,27.99000000000024,0.0,27.99000000000024,68.34542202966807,2960.44,3107.2,91.60534205505606,-8.394657944943942,40.32419455586887,33.8780142164374,0.0291053585382479,45270292952.0,1
2437,2020-01-10,3102.29,3105.22,3081.4,3092.29,210442462.0,-2.590000000000145,2.590000000000145,0.0,66.99693970503651,2960.44,3107.2,89.84055600981202,-10.15944399018798,40.31752062868645,35.16591549888721,0.029034555280462,45059850490.0,0
2438,2020-01-13,3091.49,3115.57,3075.38,3115.57,210621004.0,23.2800000000002,0.0,23.2800000000002,72.60313065410851,2960.68,3115.57,100.0,-0.0,41.70992686090858,36.47471777129149,0.0248518101854593,45270471494.0,1
2439,2020-01-14,3120.67,3127.17,3105.6,3106.82,229973769.0,-8.75,8.75,0.0,67.62150072714306,2970.66,3127.17,86.99763593380622,-13.002364066193778,41.62751092477674,37.50527640198854,0.0185894325469162,45040497725.0,0
2440,2020-01-15,3103.17,3107.94,3082.04,3090.04,202313023.0,-16.7800000000002,16.7800000000002,0.0,58.7080551428092,2980.4,3127.17,74.70191456019614,-25.29808543980385,39.7499769471824,37.95421651102731,0.0015687799818489,44838184702.0,0
2441,2020-01-16,3095.73,3096.37,3070.88,3074.08,203375475.0,-15.960000000000036,15.960000000000036,0.0,51.28862267168538,2983.34,3127.17,63.088368212472936,-36.91163178752706,36.55282095964094,37.67393740075004,-0.0031487228378067,44634809227.0,0
2442,2020-01-17,3081.46,3091.95,3067.25,3075.5,190304299.0,1.4200000000000728,0.0,1.4200000000000728,51.91251326348025,2983.34,3127.17,64.07564485851346,-35.924355141486544,33.744646656471105,36.888079251894254,-0.0025653416185327,44825113526.0,1
2443,2020-01-20,3082.11,3096.31,3070.48,3095.79,210493341.0,20.289999999999964,0.0,20.289999999999964,60.29646568055946,3030.51,3127.17,67.53569211669755,-32.46430788330245,32.778531214882605,36.06616964449193,-0.0029019582581809,45035606867.0,1
2444,2020-01-21,3085.79,3085.79,3051.23,3052.14,234830739.0,-43.65000000000009,43.65000000000009,0.0,42.08355807489414,3051.23,3127.17,1.1983144587830574,-98.80168554121694,28.166007365035057,34.48613718860056,-0.0048094323565566,44800776128.0,0
2445,2020-01-22,3038.49,3069.25,3006.27,3060.75,223852865.0,8.610000000000127,0.0,8.610000000000127,45.80902894081733,3006.27,3127.17,45.06203473945408,-54.93796526054593,24.918064093901197,32.572522569660684,-0.0110278912268004,45024628993.0,1
2446,2020-01-23,3037.95,3045.04,2955.35,2976.53,272763234.0,-84.2199999999998,84.2199999999998,0.0,26.540504337700355,2955.35,3127.17,12.326853684088157,-87.67314631591184,15.371008094079116,29.13221967454437,-0.0374350400512241,44751865759.0,0
2447,2020-02-03,2716.7,2766.58,2716.7,2746.61,215912103.0,-229.92000000000007,229.92000000000007,0.0,11.415406720984777,2716.7,3127.17,7.286768825980045,-92.71323117401997,-10.625243849873186,21.180726969660856,-0.118424557946058,44535953656.0,0
2448,2020-02-04,2685.27,2786.16,2685.27,2783.29,364046200.0,36.67999999999984,0.0,36.67999999999984,19.825937214119847,2685.27,3127.17,22.18148902466621,-77.8185109753338,-27.9455524230566,11.355471091117364,-0.1041354182089725,44899999856.0,1
2449,2020-02-05,2792.37,2842.74,2778.86,2818.09,309761823.0,34.80000000000018,0.0,34.80000000000018,27.374309201010547,2685.27,3127.17,30.056573885494487,-69.94342611450551,-38.421058542524406,1.4001651643890076,-0.0880085694683563,45209761679.0,1
2450,2020-02-06,2826.89,2876.59,2807.61,2866.51,316392142.0,48.42000000000007,0.0,48.42000000000007,36.91040470386785,2685.27,3127.17,41.01380402806069,-58.9861959719393,-42.32795298321798,-7.345458465132394,-0.0675226409202102,45526153821.0,1
2451,2020-02-07,2858.93,2875.96,2838.77,2875.96,309479642.0,9.449999999999818,0.0,9.449999999999818,38.72231865746852,2685.27,3127.17,43.15229689975108,-56.84770310024893,-44.15269417768468,-14.706905607642854,-0.064880507234596,45835633463.0,1
2452,2020-02-10,2860.5,2891.85,2851.05,2890.49,294929784.0,14.529999999999744,0.0,14.529999999999744,41.69317032699846,2685.27,3127.17,46.44037112468879,-53.55962887531122,-43.92008178955848,-20.549540844025984,-0.0663158676783632,46130563247.0,1
2453,2020-02-11,2894.54,2913.82,2882.24,2901.67,269168335.0,11.180000000000293,0.0,11.180000000000293,44.0993050887933,2685.27,3107.94,51.19833439799372,-48.80166560200628,-42.345470012086025,-24.908726677637997,-0.0492998355252379,46399731582.0,1
2454,2020-02-12,2895.56,2926.9,2892.42,2926.9,248733429.0,25.230000000000015,0.0,25.230000000000015,49.52324986215732,2685.27,3096.37,58.77645341765998,-41.22354658234003,-38.61658078458368,-27.650297499027133,-0.0437311116556399,46648465011.0,1
2455,2020-02-13,2927.14,2935.41,2901.24,2906.07,274804844.0,-20.829999999999927,20.829999999999927,0.0,45.3330660791258,2685.27,3096.31,53.717399766446135,-46.282600233553865,-36.91666380252855,-29.503570759727413,-0.0236718595142666,46373660167.0,0
2456,2020-02-14,2899.87,2926.94,2899.57,2917.01,250650627.0,10.940000000000056,0.0,10.940000000000056,47.999363271188514,2685.27,3096.31,56.37894122226553,-43.62105877773447,-34.29141073906567,-30.461138755595066,0.0620401149052831,46624310794.0,1
2457,2020-02-17,2924.99,2983.64,2924.99,2983.62,313198007.0,66.60999999999967,0.0,66.60999999999967,61.27021833097077,2685.27,3085.79,74.490662139219,-25.50933786078101,-26.53018499716154,-29.67494800390837,0.0719759708833789,46937508801.0,1
2458,2020-02-18,2981.41,2990.6,2960.78,2984.97,311665913.0,1.349999999999909,0.0,1.349999999999909,61.49998834307023,2685.27,3069.25,78.05094015313291,-21.94905984686708,-20.03942198003233,-27.74784279913316,0.0592174132124949,47249174714.0,1
2459,2020-02-19,2979.52,2998.27,2971.82,2975.4,315141151.0,-9.569999999999707,9.569999999999707,0.0,58.65375691794407,2685.27,3045.04,80.64318870389418,-19.35681129610581,-15.489115661996491,-25.296097371705827,0.0379869597524515,46934033563.0,0
2460,2020-02-20,2981.88,3031.37,2968.45,3030.15,345732881.0,54.75,0.0,54.75,68.32925869872953,2685.27,3031.37,99.64750072233464,-0.3524992776653569,-7.380025348298659,-21.712882967024395,0.0536134021335483,47279766444.0,1
2461,2020-02-21,3022.25,3058.9,3020.14,3039.67,364557276.0,9.519999999999982,0.0,9.519999999999982,69.74952684610987,2685.27,3058.9,94.8531970130878,-5.146802986912189,-0.1832164090960759,-17.406949655438734,0.0516106265719653,47644323720.0,1
2462,2020-02-24,3027.89,3042.18,3007.36,3031.23,370430044.0,-8.440000000000055,8.440000000000055,0.0,66.69018878252135,2778.86,3058.9,90.1192686759034,-9.880731324096583,4.784120696080663,-12.968735585134851,0.0446501497413558,47273893676.0,0
2463,2020-02-25,2982.07,3016.95,2943.72,3013.05,441622762.0,-18.17999999999984,18.17999999999984,0.0,60.134623596739765,2807.61,3058.9,81.75414859325882,-18.24585140674118,7.171132722118273,-8.940761923684228,0.0294338720147597,46832270914.0,0
2464,2020-02-26,2978.42,3028.78,2974.94,2987.93,469049552.0,-25.120000000000346,25.120000000000346,0.0,51.98723264720078,2838.77,3058.9,67.7599600236223,-32.240039976377695,6.955701885286544,-5.761469161890073,0.0281686263579334,46363221362.0,0
2465,2020-02-27,2992.49,3009.46,2980.48,2991.33,350523658.0,3.400000000000091,0.0,3.400000000000091,52.98209819771425,2851.05,3058.9,67.49097907144565,-32.509020928554335,6.978874854887636,-3.213400358534531,0.0254781437156539,46713745020.0,1
2466,2020-02-28,2924.64,2948.13,2878.54,2880.3,401216914.0,-111.02999999999976,111.02999999999976,0.0,29.75253755452212,2878.54,3058.9,0.9758261255268446,-99.02417387447316,-1.939595039070355,-2.958639294641696,-0.0346290747481247,46312528106.0,0
2467,2020-03-02,2899.31,2982.51,2899.31,2970.93,367333369.0,90.62999999999964,0.0,90.62999999999964,50.28291877700306,2878.54,3058.9,51.225327123530604,-48.77467287646939,-1.6751529897314867,-2.7019420336596545,-0.0047035648599483,46679861475.0,1
2468,2020-03-03,3006.89,3026.84,2976.62,2992.9,410108047.0,21.97000000000025,0.0,21.97000000000025,54.04001433583501,2878.54,3058.9,63.40652029274786,-36.593479707252136,0.3037136072116482,-2.100810905485394,0.0058815621429051,47089969522.0,1
2469,2020-03-04,2981.81,3012.0,2974.36,3011.67,353338278.0,18.769999999999985,0.0,18.769999999999985,57.22644236026512,2878.54,3058.9,73.81348414282547,-26.18651585717453,3.3479684782387267,-1.0110550287405693,-0.0060987079847532,47443307800.0,1
2470,2020-03-05,3036.15,3074.26,3022.93,3071.68,445425806.0,60.00999999999976,0.0,60.00999999999976,65.93809295944683,2878.54,3074.26,98.6817903126914,-1.3182096873085931,10.48203746860736,1.2875634707290171,0.0105307484036094,47888733606.0,1
2471,2020-03-06,3039.94,3052.44,3029.46,3034.51,362061533.0,-37.16999999999962,37.16999999999962,0.0,57.5597048456063,2878.54,3074.26,79.69037400367876,-20.309625996321248,12.986826136633226,3.62741600390986,0.0010820689950945,47526672073.0,0
2472,2020-03-09,2987.18,2989.21,2940.71,2943.29,414560736.0,-91.22000000000024,91.22000000000024,0.0,42.32932206439122,2878.54,3074.26,33.08297567954216,-66.91702432045784,7.524460265295602,4.40682485618701,-0.0231526194387747,47112111337.0,0
2473,2020-03-10,2918.93,3000.3,2904.8,2996.76,393296648.0,53.470000000000255,0.0,53.470000000000255,51.08350493897686,2878.54,3074.26,60.40261598201517,-39.59738401798483,7.424493155099299,5.010358515969468,0.0029552231812661,47505407985.0,1
2474,2020-03-11,3001.76,3010.03,2968.52,2968.52,352470970.0,-28.24000000000024,28.24000000000024,0.0,46.75816329655741,2878.54,3074.26,45.97384017984872,-54.026159820151285,5.008798203748029,5.010046453525181,-0.0076253706545248,47152937015.0,0
2475,2020-03-12,2936.02,2944.47,2906.28,2923.49,307778457.0,-45.0300000000002,45.0300000000002,0.0,40.45577175277215,2878.54,3074.26,22.966482730431107,-77.03351726956889,-0.5330573644473589,3.901425689930673,0.0149949658021732,46845158558.0,0
2476,2020-03-13,2804.23,2910.88,2799.98,2887.43,366450436.0,-36.059999999999945,36.059999999999945,0.0,35.97529724626796,2799.98,3074.26,31.883476739098644,-68.11652326090136,-7.745473466430212,1.5720458586584956,-0.028105677346824,46478708122.0,0
2477,2020-03-16,2897.3,2898.03,2784.66,2789.25,351878665.0,-98.17999999999984,98.17999999999984,0.0,26.689341795889675,2784.66,3074.26,1.5849447513812638,-98.41505524861871,-21.139982110816163,-2.9703597352364377,-0.0680443716796418,46126829457.0,0
2478,2020-03-17,2796.28,2826.91,2715.22,2779.64,306149677.0,-9.610000000000127,9.610000000000127,0.0,25.933329685126463,2715.22,3074.26,17.94229055258467,-82.05770944741533,-32.15995347481294,-8.80827848315174,-0.0770436335986347,45820679780.0,0
2479,2020-03-18,2792.32,2815.87,2728.76,2728.76,291159852.0,-50.87999999999965,50.87999999999965,0.0,22.10767638471347,2715.22,3074.26,3.771167557932377,-96.22883244206764,-44.48614239561084,-15.943851265643564,-0.1116392332534638,45529519928.0,0
2480,2020-03-19,2719.41,2736.82,2646.8,2702.13,302302747.0,-26.63000000000011,26.63000000000011,0.0,20.299255901531865,2646.8,3074.26,12.943901183736472,-87.05609881626353,-55.760778816228594,-23.907236775760573,-0.1095333348711983,45227217181.0,0
2481,2020-03-20,2727.02,2751.9,2702.49,2745.62,252019507.0,43.48999999999978,0.0,43.48999999999978,30.943759176893124,2646.8,3074.26,23.11795255696433,-76.88204744303567,-60.489445199149486,-31.22367846043836,-0.0671595391551631,45479236688.0,1
2482,2020-03-23,2677.59,2703.33,2656.5,2660.17,249820250.0,-85.44999999999982,85.44999999999982,0.0,23.75201730694532,2646.8,3074.26,3.127778037711105,-96.87222196228888,-70.32142660799991,-39.043228089950674,-0.1123179700743469,45229416438.0,0
2483,2020-03-24,2703.02,2723.41,2667.13,2722.44,257021930.0,62.26999999999998,0.0,62.26999999999998,36.21673556970708,2646.8,3074.26,17.695222944836914,-82.30477705516309,-72.25575475900314,-45.68573342376117,-0.0828965275625563,45486438368.0,1
2484,2020-03-25,2775.3,2788.64,2757.8,2781.59,273144466.0,59.15000000000009,0.0,59.15000000000009,45.90857710348264,2646.8,3052.44,33.22897150182428,-66.77102849817572,-68.22930809942909,-50.19444835889476,-0.0485378776736022,45759582834.0,1
2485,2020-03-26,2761.9,2788.5,2753.43,2764.91,234084022.0,-16.68000000000029,16.68000000000029,0.0,43.74573657310766,2646.8,3010.03,32.51658728629234,-67.48341271370765,-65.62774096615112,-53.28110688034604,-0.0424321974905019,45525498812.0,0
2486,2020-03-27,2792.98,2805.55,2771.76,2772.2,240764066.0,7.289999999999964,0.0,7.289999999999964,45.05121044964926,2646.8,3010.03,34.5235801007625,-65.4764198992375,-62.2600431726587,-55.07689413880857,-0.0061127543246393,45766262878.0,1
2487,2020-03-30,2739.72,2759.1,2723.05,2747.21,239706604.0,-24.98999999999978,24.98999999999978,0.0,41.26359052212165,2646.8,3010.03,27.64364176967757,-72.35635823032243,-60.90552161738424,-56.2426196345237,-0.0116669784576419,45526556274.0,0
2488,2020-03-31,2767.31,2771.17,2743.12,2750.3,218598674.0,3.090000000000145,0.0,3.090000000000145,41.959782619132575,2646.8,2944.47,34.77004736789066,-65.22995263210933,-58.90371103570397,-56.77483791475976,0.0078936953048271,45745154948.0,1
2489,2020-04-01,2743.54,2773.36,2731.08,2734.52,217253427.0,-15.7800000000002,15.7800000000002,0.0,39.22053298959767,2646.8,2910.88,33.217206906997816,-66.7827930930022,-57.92287697842448,-57.0044457274927,0.0119868400113982,45527901521.0,0
2490,2020-04-02,2720.23,2780.64,2719.9,2780.64,217864600.0,46.11999999999989,0.0,46.11999999999989,50.18709416333578,2646.8,2898.03,53.27389244915005,-46.726107550849946,-52.81523916171364,-56.16660441433689,0.0127548604686738,45745766121.0,1
2491,2020-04-03,2773.58,2780.59,2754.07,2763.99,200837404.0,-16.65000000000009,16.65000000000009,0.0,46.67872406752241,2646.8,2826.91,65.06579312642263,-34.93420687357736,-49.53985068239035,-54.841253667947576,0.0390275809440749,45544928717.0,0
2492,2020-04-07,2806.97,2823.28,2801.84,2820.76,270198186.0,56.77000000000044,0.0,56.77000000000044,58.18008138953567,2646.8,2823.28,98.57207615593836,-1.4279238440616395,-41.88044545577122,-52.249092025512304,0.0361146618474603,45815126903.0,1
2493,2020-04-08,2805.92,2823.21,2800.3,2815.37,243515305.0,-5.390000000000327,5.390000000000327,0.0,56.837014633956,2646.8,2823.28,95.5179057116952,-4.482094288304799,-35.83218842117503,-48.965711304644856,0.0121441333913336,45571611598.0,0
2494,2020-04-09,2825.84,2832.4,2820.43,2825.9,238184843.0,10.5300000000002,0.0,10.5300000000002,58.971982392325714,2656.5,2832.4,96.30471859010802,-3.695281409891983,-29.845181474739547,-45.1416053386638,0.0220585841853804,45809796441.0,1
2495,2020-04-10,2827.19,2833.01,2789.98,2796.63,233454768.0,-29.269999999999985,29.269999999999985,0.0,50.897438011518695,2656.5,2833.01,79.38926972976031,-20.61073027023968,-27.14931926343297,-41.54314812361764,0.0088124954909458,45576341673.0,0
2496,2020-04-13,2784.6,2792.89,2774.08,2783.05,177124554.0,-13.579999999999927,13.579999999999927,0.0,47.42149614242568,2667.13,2833.01,69.8818422956354,-30.1181577043646,-25.8110873968717,-38.39673597826845,0.0130459629951842,45399217119.0,0
2497,2020-04-14,2794.8,2827.3,2789.43,2827.28,202696569.0,44.23000000000002,0.0,44.23000000000002,58.15979452656657,2719.9,2833.01,94.93413491291662,-5.065865087083381,-20.94015260230799,-34.905419303076364,0.0279896738537615,45601913688.0,1
2498,2020-04-15,2826.66,2829.75,2808.7,2811.17,205621146.0,-16.110000000000127,16.110000000000127,0.0,53.56238044929019,2719.9,2833.01,80.69136239059313,-19.30863760940688,-18.170387135315195,-31.55841286952413,0.0280305135819083,45396292542.0,0
2499,2020-04-16,2798.43,2823.34,2796.84,2819.94,203003773.0,8.769999999999982,0.0,8.769999999999982,55.75906171702648,2719.9,2833.01,88.44487666872942,-11.555123331270575,-15.093671887555049,-28.265464673130317,0.0141334369066115,45599296315.0,1
2500,2020-04-17,2835.56,2854.96,2830.02,2838.49,245736750.0,18.549999999999727,0.0,18.549999999999727,60.33799191842798,2719.9,2854.96,87.80541981341607,-12.194580186583934,-11.031360261672944,-24.81864379083884,0.0269537878212293,45845033065.0,1
2501,2020-04-20,2840.41,2852.99,2833.26,2852.55,211847078.0,14.0600000000004,0.0,14.0600000000004,63.63007935424144,2719.9,2854.96,98.21560787798026,-1.7843921220197358,-6.60132852901188,-21.17518073847345,0.0112700123371005,46056880143.0,1
2502,2020-04-21,2842.24,2842.24,2808.02,2827.01,233235870.0,-25.539999999999964,25.539999999999964,0.0,54.2006643273182,2719.9,2854.96,79.30549385458328,-20.694506145416725,-5.092656048675963,-17.958675800513955,0.004134447692488,45823644273.0,0
2503,2020-04-22,2814.07,2843.98,2808.48,2843.98,217320000.0,16.9699999999998,0.0,16.9699999999998,58.87323319605076,2719.9,2854.96,91.87027987561083,-8.129720124389177,-2.498879535037304,-14.866716547418624,0.0063979617113132,46040964273.0,1
2504,2020-04-23,2850.51,2853.64,2835.9,2838.5,248779037.0,-5.480000000000018,5.480000000000018,0.0,56.71718806836811,2754.07,2854.96,83.68520170482698,-16.314798295173016,-0.8753921863453797,-12.068451675203976,0.0149715908075076,45792185236.0,0
2505,2020-04-24,2834.94,2834.94,2802.5,2808.53,235185076.0,-29.9699999999998,29.9699999999998,0.0,46.070451283118814,2774.08,2854.96,42.59396636993104,-57.40603363006896,-1.9842224153035204,-10.051605823223886,0.0091554230071324,45557000160.0,0
2506,2020-04-27,2812.24,2832.67,2802.96,2815.49,210130981.0,6.959999999999582,0.0,6.959999999999582,48.65321958019384,2774.08,2854.96,51.19930761622131,-48.80069238377869,-2.2751381512080115,-8.496312288820711,-0.0041700857361139,45767131141.0,1
2507,2020-04-28,2819.99,2821.75,2758.25,2810.02,253872745.0,-5.4699999999998,5.4699999999998,0.0,46.62818177643635,2758.25,2854.96,53.5311756798676,-46.4688243201324,-2.9134893613754684,-7.379747703331662,-0.0004090823393818,45513258396.0,0
2508,2020-04-29,2801.38,2831.76,2800.74,2822.44,202061807.0,12.420000000000073,0.0,12.420000000000073,51.87585467407875,2758.25,2854.96,66.37369455071868,-33.626305449281325,-2.3896506871606107,-6.3817283000974525,0.0008865436853267,45715320203.0,1
2509,2020-04-30,2832.38,2865.59,2832.38,2860.08,242455278.0,37.63999999999987,0.0,37.63999999999987,64.18853853619069,2758.25,2865.59,94.86677846096497,-5.13322153903504,1.0506177976194522,-4.895259080554072,0.0076061567946337,45957775481.0,1
2510,2020-05-06,2831.63,2879.26,2830.65,2878.14,249826616.0,18.059999999999945,0.0,18.059999999999945,68.63174143966754,2758.25,2879.26,99.07445665647438,-0.9255433435256124,5.174695752388288,-2.8812681139656,0.0089709207551136,46207602097.0,1
2511,2020-05-07,2876.47,2882.02,2864.58,2871.52,226736957.0,-6.619999999999891,6.619999999999891,0.0,65.20978093480784,2758.25,2882.02,91.51652258220894,-8.483477417791066,7.818748899260754,-0.7412647113203283,0.0157445498954724,45980865140.0,0
2512,2020-05-08,2882.71,2903.8,2879.2,2895.34,226822075.0,23.820000000000164,0.0,23.820000000000164,71.17641774826802,2758.25,2903.8,94.18756441085536,-5.812435589144641,11.701368898669898,1.7472620106777177,0.0180591987285423,46207687215.0,1
2513,2020-05-11,2901.57,2914.28,2884.38,2894.8,225120410.0,-0.5399999999999636,0.5399999999999636,0.0,70.8585367784599,2758.25,2914.28,87.51522143177594,-12.484778568224057,14.566881788250612,4.311185966192298,0.0198344195878106,45982566805.0,0
2514,2020-05-12,2894.62,2897.9,2871.23,2891.56,197082985.0,-3.2400000000002365,3.2400000000002365,0.0,68.73335965415326,2758.25,2914.28,85.43869768634222,-14.561302313657777,16.38747585515057,6.726443943983953,0.0295635083121774,45785483820.0,0
2515,2020-05-13,2882.96,2900.26,2875.54,2898.05,185061310.0,6.4900000000002365,0.0,6.4900000000002365,70.76022358073729,2758.25,2914.28,89.59815420111518,-10.401845798884828,18.14483615422978,9.01012238603312,0.0293234925359353,45970545130.0,1
2516,2020-05-14,2887.06,2887.06,2869.18,2870.34,197776202.0,-27.71000000000004,27.71000000000004,0.0,53.63215602985328,2758.25,2914.28,71.83874895853361,-28.161251041466382,17.104422301322302,10.628982369090958,0.02146603938762,45772768928.0,0
2517,2020-05-15,2880.71,2884.22,2863.37,2868.46,188983592.0,-1.8800000000001087,1.8800000000001087,0.0,52.63477484690807,2758.25,2914.28,70.63385246426962,-29.366147535730374,15.94438954133784,11.692063803540336,0.01630504102833,45583785336.0,0
2518,2020-05-18,2872.52,2889.98,2862.27,2875.42,226022882.0,6.960000000000036,0.0,6.960000000000036,56.12052781827887,2758.25,2914.28,75.09453310260842,-24.905466897391577,15.409043196149469,12.435459682062165,0.0053634863360465,45809808218.0,1
2519,2020-05-19,2897.69,2900.22,2887.58,2898.58,197222405.0,23.15999999999985,0.0,23.15999999999985,65.78764862951078,2758.25,2914.28,89.93783246811495,-10.062167531885056,16.661532034578613,13.280674152565457,0.0071018088070768,46007030623.0,1
2520,2020-05-20,2896.47,2896.47,2876.18,2883.74,210519985.0,-14.840000000000146,14.840000000000146,0.0,56.572827872474285,2758.25,2914.28,80.42684099211665,-19.57315900788334,16.269134035802836,13.878366129212935,0.0042555858917925,45796510638.0,0
2521,2020-05-21,2890.72,2891.52,2864.21,2867.92,203532038.0,-15.819999999999707,15.819999999999707,0.0,48.25834183918109,2800.74,2914.28,59.16857495155896,-40.83142504844104,14.514302167408005,14.005553336851948,-0.0094703903513923,45592978600.0,0
2522,2020-05-22,2863.05,2863.05,2808.02,2813.77,209063712.0,-54.15000000000009,54.15000000000009,0.0,30.53449081977369,2808.02,2914.28,5.4112554112554,-94.5887445887446,8.654370621885846,12.935316793858728,-0.0279915710929944,45383914888.0,0
2523,2020-05-25,2816.24,2821.5,2802.47,2817.97,172885557.0,4.199999999999818,0.0,4.199999999999818,32.74508222750113,2802.47,2914.28,13.86280296932291,-86.13719703067709,4.299673591954161,11.208188153477815,-0.0254499301415153,45556800445.0,1
2524,2020-05-26,2827.9,2848.34,2825.9,2846.55,174562369.0,28.580000000000386,0.0,28.580000000000386,46.190122276168026,2802.47,2914.28,39.424022895984464,-60.57597710401554,3.118760835261128,9.59030268983448,-0.0177705698659443,45731362814.0,1
2525,2020-05-27,2847.32,2849.0,2831.93,2836.8,198149343.0,-9.75,9.75,0.0,42.82050815920507,2802.47,2914.28,30.70387264108779,-69.2961273589122,1.3802250761968935,7.948287167106962,-0.0116850268609293,45533213471.0,0
2526,2020-05-28,2838.21,2861.92,2820.15,2846.22,207546019.0,9.419999999999618,0.0,9.419999999999618,47.12091168994584,2802.47,2914.28,39.12887934889531,-60.87112065110469,0.7538483410189656,6.509399401889362,-0.0077532892213941,45740759490.0,1
2527,2020-05-29,2835.58,2855.38,2829.63,2852.35,206792804.0,6.130000000000109,0.0,6.130000000000109,49.947436008486825,2802.47,2900.26,51.00726045607925,-48.99273954392076,0.7435093223921285,5.356221385989916,-0.0080231757447608,45947552294.0,1
2528,2020-06-01,2871.96,2917.15,2871.96,2915.43,260196050.0,63.07999999999993,0.0,63.07999999999993,69.38062860673021,2802.47,2917.15,98.50017439832556,-1.4998256016744422,5.758958702984728,5.436768849388879,0.005813191286768,46207748344.0,1
2529,2020-06-02,2916.32,2926.36,2909.13,2921.4,256108049.0,5.970000000000255,0.0,5.970000000000255,70.6260346170462,2802.47,2926.36,95.9964484623456,-4.003551537654389,10.09905199315881,6.369225478142866,0.0130594297682871,46463856393.0,1
2530,2020-06-03,2930.39,2942.76,2922.66,2923.37,255663980.0,1.9699999999998,0.0,1.9699999999998,71.07399839079406,2802.47,2942.76,86.17862998075397,-13.82137001924604,13.54147206958396,7.803674796431086,0.0193345700019524,46719520373.0,1
2531,2020-06-04,2931.84,2932.97,2910.75,2919.25,226605873.0,-4.119999999999891,4.119999999999891,0.0,68.55124634135873,2802.47,2942.76,83.24185615510717,-16.758143844892828,15.755545097329104,9.394048856610691,0.0374870725041491,46492914500.0,0
2532,2020-06-05,2923.19,2930.8,2909.12,2930.8,217360673.0,11.550000000000182,0.0,11.550000000000182,71.79014492438088,2802.47,2942.76,91.47480219545228,-8.525197804547723,18.2320348473022,11.161646054748994,0.0400394610304581,46710275173.0,1
2533,2020-06-08,2941.98,2950.07,2934.21,2937.77,231124360.0,6.9699999999998,0.0,6.9699999999998,73.67776818763409,2802.47,2950.07,91.66666666666656,-8.333333333333435,20.52054351355173,13.033425546509545,0.0320458098399816,46941399533.0,1
2534,2020-06-09,2939.54,2957.12,2932.94,2956.11,209048585.0,18.340000000000146,0.0,18.340000000000146,78.12233886880065,2802.47,2957.12,99.34691238280004,-0.6530876171999761,23.54270222911964,15.135280883031566,0.0420579526226734,47150448118.0,1
2535,2020-06-10,2951.28,2951.33,2934.84,2943.75,207925969.0,-12.360000000000127,12.360000000000127,0.0,69.0551949451889,2802.47,2957.12,91.35467183963796,-8.645328160362032,24.656214587708742,17.039467623967006,0.0342665008326834,46942522149.0,0
2536,2020-06-11,2939.79,2952.65,2912.19,2920.9,233722947.0,-22.84999999999991,22.84999999999991,0.0,55.35143360667502,2802.47,2957.12,76.57937277723907,-23.42062722276093,23.42485003004822,18.31654410518325,0.0240328150472417,46708799202.0,0
2537,2020-06-12,2876.8,2930.26,2872.62,2919.74,236008642.0,-1.1600000000003092,1.1600000000003092,0.0,54.71541065864576,2820.15,2957.12,72.70935241293702,-27.29064758706298,22.100620248063024,19.073359333759207,0.0014783411023415,46472790560.0,0
2538,2020-06-15,2908.28,2922.54,2890.03,2890.03,243205046.0,-29.70999999999958,29.70999999999958,0.0,40.84533229464304,2820.15,2957.12,51.01847119807272,-48.98152880192728,18.44123087188564,18.946933641384494,-0.010738002327651,46229585514.0,0
2539,2020-06-16,2912.83,2931.78,2909.13,2931.75,223313065.0,41.7199999999998,0.0,41.7199999999998,58.06811135045031,2820.15,2957.12,81.47769584580571,-18.5223041541943,18.69212260426093,18.895971433959783,0.0028665546954371,46452898579.0,1
2540,2020-06-17,2932.67,2936.62,2919.04,2935.87,234654391.0,4.119999999999891,0.0,4.119999999999891,59.414546489865806,2829.63,2957.12,83.33202604125812,-16.667973958741893,19.00433552729828,18.917644252627483,0.0056932431275156,46687552970.0,1
2541,2020-06-18,2929.88,2942.9,2920.11,2939.32,258691377.0,3.450000000000273,0.0,3.450000000000273,60.63581746660129,2871.96,2957.12,79.09816815406322,-20.901831845936776,19.30758684275725,18.99563277065344,0.0029070560938992,46946244347.0,1
2542,2020-06-19,2938.79,2973.32,2935.82,2967.63,264313961.0,28.309999999999945,0.0,28.309999999999945,69.36429022366073,2872.62,2973.32,94.34955312810324,-5.6504468718967615,21.583495003385,19.51320521719975,0.0101641721441774,47210558308.0,1
2543,2020-06-22,2966.9,2983.44,2959.04,2965.27,267883834.0,-2.3600000000001278,2.3600000000001278,0.0,67.91575977837103,2872.62,2983.44,83.60404259158992,-16.395957408410077,22.93238606936484,20.19704138763277,0.0030986668290422,46942674474.0,0
2544,2020-06-23,2960.89,2972.4,2949.85,2970.62,225212208.0,5.349999999999909,0.0,5.349999999999909,69.57754765485534,2872.62,2983.44,88.43169103049978,-11.56830896950022,24.154652447902663,20.98856359968675,0.0091278131634819,47167886682.0,1
2545,2020-06-24,2972.98,2982.94,2971.22,2979.55,213200732.0,8.930000000000291,0.0,8.930000000000291,72.33703344610056,2872.62,2983.44,96.48980328460578,-3.510196715394213,25.549366534245564,21.900724186598516,0.020079427573693,47381087414.0,1
2546,2020-06-29,2973.08,2977.91,2951.77,2961.52,220622729.0,-18.0300000000002,18.0300000000002,0.0,59.71787333733293,2872.62,2983.44,80.22017686338202,-19.77982313661797,24.912639775292973,22.50310730433741,0.0143094933110483,47160464685.0,0
2547,2020-06-30,2965.11,2990.83,2965.11,2984.67,214957214.0,23.15000000000009,0.0,23.15000000000009,67.99062709675695,2872.62,2990.83,94.78893494628215,-5.211065053717835,25.9765986989014,23.197805583250208,0.0327470649093608,47375421899.0,1
2548,2020-07-01,2991.18,3026.19,2984.98,3025.98,273313140.0,41.309999999999945,0.0,41.309999999999945,77.50339339099087,2872.62,3026.19,99.86325454190268,-0.1367454580973081,29.80953975074408,24.520152416748985,0.0321412125863391,47648735039.0,1
2549,2020-07-02,3023.72,3092.44,3021.67,3090.57,391127996.0,64.59000000000015,0.0,64.59000000000015,85.35521775240439,2872.62,3092.44,99.1493039759804,-0.8506960240196022,37.62532502212298,27.14118693782379,0.0526930688347917,48039863035.0,1
2550,2020-07-03,3104.0,3152.81,3104.0,3152.81,458793851.0,62.23999999999978,0.0,62.23999999999978,89.44950700851385,2872.62,3152.81,100.0,-0.0,48.28503912337828,31.36995737493469,0.0726324455996625,48498656886.0,1
2551,2020-07-06,3187.84,3337.27,3187.84,3332.88,643878906.0,180.07000000000016,0.0,180.07000000000016,94.54271811523492,2890.03,3337.27,99.01842411233343,-0.9815758876665492,70.45096852893903,39.18615960573556,0.1230780117467473,49142535792.0,1
2552,2020-07-07,3380.95,3407.08,3336.24,3345.34,657840159.0,12.460000000000036,0.0,12.460000000000036,94.7452509713756,2909.13,3407.08,87.60116477557992,-12.398835224420084,88.00853751017394,48.950635186623245,0.1281738256549993,49800375951.0,1
2553,2020-07-08,3337.55,3421.53,3327.71,3403.44,587081685.0,58.09999999999991,0.0,58.09999999999991,95.61985854400164,2919.04,3421.53,96.3999283567832,-3.600071643216808,105.39627916202198,60.239763981703,0.1457002241956224,50387457636.0,1
2554,2020-07-09,3403.48,3456.97,3393.64,3450.59,620001823.0,47.15000000000009,0.0,47.15000000000009,96.21046789279536,2920.11,3456.97,98.8116082405097,-1.1883917594903064,121.5793100384044,72.50767319304329,0.1580909868939941,51007459459.0,1
2555,2020-07-10,3418.93,3433.11,3372.51,3383.32,556120011.0,-67.26999999999998,67.26999999999998,0.0,78.73372104491587,2935.82,3456.97,85.86779238223167,-14.132207617768335,127.5065358243064,83.50744571929592,0.1424268618817363,50451339448.0,0
2556,2020-07-13,3379.39,3458.79,3369.04,3443.29,558006875.0,59.9699999999998,0.0,59.9699999999998,82.08178366646229,2949.85,3458.79,96.9544543561127,-3.0455456438872948,135.48123937936543,93.90220445130984,0.1536585284135263,51009346323.0,1
2557,2020-07-14,3435.02,3451.22,3366.08,3414.62,543211492.0,-28.670000000000076,28.670000000000076,0.0,75.52300634266527,2949.85,3458.79,91.32117734899988,-8.678822651000132,137.89821522017382,102.70140660508262,0.128434424550063,50466134831.0,0
2558,2020-07-15,3422.08,3432.45,3345.75,3361.3,492030542.0,-53.31999999999971,53.31999999999971,0.0,64.46861585215854,2951.77,3458.79,80.77196165831727,-19.228038341682733,133.9669203351068,108.95450935108748,0.0875987277427787,49974104289.0,0
2559,2020-07-16,3356.36,3373.53,3209.73,3210.1,490613123.0,-151.20000000000027,151.20000000000027,0.0,43.5916169625698,2951.77,3458.79,50.95065283420771,-49.04934716579229,117.29861898258925,110.62333127738783,0.0181710918196782,49483491166.0,0
2560,2020-07-17,3214.4,3252.78,3181.27,3214.13,359652413.0,4.0300000000002,0.0,4.0300000000002,44.1478550718439,2965.11,3458.79,50.44158159131422,-49.558418408685775,103.22415360403512,109.14349574271728,-0.0356298456590096,49843143579.0,1
